cgacgaatataaatagaaaagtgcacatttcaacgatttttgagttgtattttattttcacattgactactttgtccccgaatccactaatctccttgagtcaatctgtttgaaggagaaaatgcattgatccgtgaaaatgtgtgtgtgctttttgaagggaggaagagaaaaagtataagaggttcctcttccctatt	gaatataaatagaaaagtgcacatttcaacgatttttgagttgtattttattttcacattgactactttgtccccgaatccactaatctccttgagtcaatctgtttgaaggagaaaatgcattgatccgtgaaaatgtgtgtgtgctttttgaagggaggaagagaaaaagtataagaggttcctcttccctattctac	4TLS
ttaaaactgcgcgttttgcgttaaaaatcgaatttctatggaaaaaatggaatttttagctggaaaattggaaaaaacgtgttttttcccgtttaaaagctattttttatacaaaaagcgaaaaaaaaaggatttttagcgaaaaattcctgtttttaaaaattttaatcttaaaaaaaatggttttttttaggaaaaat	cgcgttttgcgttaaaaatcgaatttctatggaaaaaatggaatttttagctggaaaattggaaaaaacgtgttttttcccgtttaaaagctattttttatacaaaaagcgaaaaaaaaaggatttttagcgaaaaattcctgtttttaaaaattttaatcttaaaaaaaatggttttttttaggaaaaattctaatttt	4TLS
ttgcggaagccgaaaatgaaaagtactactgtgaacctgcggataacaaaaacctacctatcaaacttggagataacatctaccaatacgatgtcaacacttatgacgatattgatgtaagttatgacgatattgatgtaagtaaaaaacattttaaatgtcgggattcagggcgttggagcaatgggaagtattaataa	agtactactgtgaacctgcggataacaaaaacctacctatcaaacttggagataacatctaccaatacgatgtcaacacttatgacgatattgatgtaagttatgacgatattgatgtaagtaaaaaacattttaaatgtcgggattcagggcgttggagcaatgggaagtattaataaggatacacacgatgcgctgaa	4TLS
tgacgtcacaatcttggcaaagtagtcattttgcgggcttaggggtcaagttgtaagtcaaatatttttgaccattttgttagttgagatcaggggtgtgcggcaaatttgccgatttgccgagctcggcaaatttgccgatttgccgaattcggcaaatttaaaaaagccagcaattgccgatttgccgagctcggcaa	cattttgcgggcttaggggtcaagttgtaagtcaaatatttttgaccattttgttagttgagatcaggggtgtgcggcaaatttgccgatttgccgagctcggcaaatttgccgatttgccgaattcggcaaatttaaaaaagccagcaattgccgatttgccgagctcggcaattttcaaaaaagtagatttgccgaat	4TLS
aaacaatcaataaaaatgtagtgaataaatttttgaatgaaattatatcttctttcaaaacgtgcactttttcctttaattaaataatattatttttcaattaccattaaagtgcaaagtttttattttgagtcaaagttttgttaaatgccaaattttcaaaaagtatggacttttgagacgtttttaggcgtatttga	ttatatcttctttcaaaacgtgcactttttcctttaattaaataatattatttttcaattaccattaaagtgcaaagtttttattttgagtcaaagttttgttaaatgccaaattttcaaaaagtatggacttttgagacgtttttaggcgtatttgaaggttcaaatccataactggttaaaaatagaaataaataaca	4TLS
aaaatacttgaaacaaaggtattacaagaaaaatgtagcctgcatttcaacataatttttttttcagttttccatttgcaatggtagtgttagctccaactcaactcacatgtccagttatctgtatcctatacttaatacttatcaaaccgcttcgttatggtttttttaaactagtgggtcttcataagtatgttcca	tttcaacataatttttttttcagttttccatttgcaatggtagtgttagctccaactcaactcacatgtccagttatctgtatcctatacttaatacttatcaaaccgcttcgttatggtttttttaaactagtgggtcttcataagtatgttccaagaaaccaaccaaaagcagtaacgcaaacacgtaagattttttg	4TLS
ggaattttaaggagttttcagcgtgtatcggagtatttccggataaaattgactttttctggttaaaattaaataaaaaaaataaaatttagtgagaattgtcacagatgcgtttcgtcacagatttttggggaaaatagtcaacgagaagtcagctcaagggaaaatagaaaccgctcaactagatgaaaagatgggct	gactttttctggttaaaattaaataaaaaaaataaaatttagtgagaattgtcacagatgcgtttcgtcacagatttttggggaaaatagtcaacgagaagtcagctcaagggaaaatagaaaccgctcaactagatgaaaagatgggctccgcttggattcgtcaaaactctggggggcgtcaattcatgcagattcct	4TLS
agtactatatttcaaaaacattgatttcttttgttgttgtatatttgtaaatattgttttgttttgtaaataatttattaaaaatctcatatacagacaacaaaaatcaacaaagaaaatcaaagttgaaaactcaaagtttgaatatcaagtcaagaaatgtaatactacaaattcaatagcccgtaattgaatatttg	ttgttttgttttgtaaataatttattaaaaatctcatatacagacaacaaaaatcaacaaagaaaatcaaagttgaaaactcaaagtttgaatatcaagtcaagaaatgtaatactacaaattcaatagcccgtaattgaatatttgttgttggacggagacttgagagtaattccagaattctgcacaaaaagcgaggg	4TLS
gcttccggttctgcttcaaattcaattcgaccatcaatcggaagctcgtctgtgacaacacgagttccaaacacattggccagagtcttgttgaaaaaagagctgaaagatgtgctgattcaaagaaaacaacgtttggaagctactgaaattgaagcaaaccaacgacattacaaagttcaaaagatgctgataacagg	caacacgagttccaaacacattggccagagtcttgttgaaaaaagagctgaaagatgtgctgattcaaagaaaacaacgtttggaagctactgaaattgaagcaaaccaacgacattacaaagttcaaaagatgctgataacaggattactacctgagaaacctgaagatgatattccgaacatcgtcaaatgtgatctt	4TLS
gattttataggcttgacatcaaaaaacgtgagaaagttggcaaggattttgcaaccttggagattcaaaaatgtgggaaaattctcaataacttgtgacctgcgtgagctatttttaagttttattttaacaaatcagaattggcaacaactggaatttttaaaagatcaaataccataagctgatgcgcttccatttag	ttggagattcaaaaatgtgggaaaattctcaataacttgtgacctgcgtgagctatttttaagttttattttaacaaatcagaattggcaacaactggaatttttaaaagatcaaataccataagctgatgcgcttccatttaggcctacgcctgccttctgtaaaagtgcaccctgaaaaaattaaagttttcagtctc	4TLS
gcttttttactattattaaatttaaaagttgacctattataactttttctcaataagaagtttcaattttcatactaattactacttctatacagtttttttcgatgttactttaaaaaattgaaaacttgtccttataaattagaattttctggttattcttattatttctgttgaaattgaactttaaaacgttttca	agtttcaattttcatactaattactacttctatacagtttttttcgatgttactttaaaaaattgaaaacttgtccttataaattagaattttctggttattcttattatttctgttgaaattgaactttaaaacgttttcaattgttctttgagttaaaatattaatttttataacaaaatttaaaaaaaaaaccgcag	4TLS
gtactcccttatactgccagccgtctcctcattgtgcttgttcagctgcctgccactttcgcctctcgctatctctttcatttctctccttttttttaatggcaccgattacactgcattcccgtgtcctcggtagtatagtggtgagtatccgcgtctgtcacatgcgagacccgggttcaattcccggccggggagaa	gcctctcgctatctctttcatttctctccttttttttaatggcaccgattacactgcattcccgtgtcctcggtagtatagtggtgagtatccgcgtctgtcacatgcgagacccgggttcaattcccggccggggagaaccttttttgcacaattctatcaacaggttgcccagctgggatatgtgacctgaatcccat	4TLS
agacaagagtactatatttcaaaaacattgatttcttttgttgttgtatatttgtaaatattgttttgttttgtaaataatttattaaaaatctcatatacagacaacaaaaatcaacaaagaaaatcaaagttgaaaactcaaagtttgaatatcaagtcaagaaatgtaatactacaaattcaatagcccgtaattga	ttgttttgttttgtaaataatttattaaaaatctcatatacagacaacaaaaatcaacaaagaaaatcaaagttgaaaactcaaagtttgaatatcaagtcaagaaatgtaatactacaaattcaatagcccgtaattgaatatttgttgttggacggagacttgagagtaattccagaattctgcacaaaaagcgaggg	4TLS
cgtcgttggatttggtgagggtgagtggtaggagtaggcttgcctgcctagtaggtaggcaaacaagcaggcaactttccaatttttccaggcactcacaatgcaggcaatgttcccgatggtatgccttcttcccaatgttgcatacttccttgtggcgcaggtgagataggcaggcaggcaggcacgcctagcccatt	aacaagcaggcaactttccaatttttccaggcactcacaatgcaggcaatgttcccgatggtatgccttcttcccaatgttgcatacttccttgtggcgcaggtgagataggcaggcaggcaggcacgcctagcccattgaaaaatttccagcgaatccacatcgagttcgagattgccgagttcgtgccgtttccaacc	4TLS
tttttaaattatagaggcattttccgggtaaggaacgaagagtcgcacttttgttcttttaattctcaatagttttacaactgtttttcgcaaaatctgaaaataataaaaggtggagtaccgaaatttgagactttgcgtttttagacccaaaatggtccaaaattaccaaatttcgtaatgagacgttctgaattttt	attctcaatagttttacaactgtttttcgcaaaatctgaaaataataaaaggtggagtaccgaaatttgagactttgcgtttttagacccaaaatggtccaaaattaccaaatttcgtaatgagacgttctgaatttttttaattttcgaaattttttaaaattttatttttaatgacaaaaatcggaatttttcggcgg	4TLS
tttttcataggatgaatggaaataagacaaaaaaatctcgattagctttatccaaatcagatcgatatcaatgattacgaaacaacaagatcttgcgataagatttctaacaattggcaaattttcatacacaggaaatgtgaataatttgtagcctaggaggtgaatttttaaaaatccgtatcttttagttttttttg	cgatatcaatgattacgaaacaacaagatcttgcgataagatttctaacaattggcaaattttcatacacaggaaatgtgaataatttgtagcctaggaggtgaatttttaaaaatccgtatcttttagttttttttgaaacgtttccaaaaaagttttatagggactattgggtattttcggcttactaggaaataacc	4TLS
cattttcacccattcggatgctgattcaaagcccatctctcaattagcaacagctcctttttcctctcattccattggttcttcttcagtgctttttctttgttttcttgcggtcacgtcacattttaaccatatattctttcattgtttctatttcagaaaatgtcttcaatcgttgttggaagtggagttcttgctga	ctctcattccattggttcttcttcagtgctttttctttgttttcttgcggtcacgtcacattttaaccatatattctttcattgtttctatttcagaaaatgtcttcaatcgttgttggaagtggagttcttgctgaaactgtcgtcggtctttgtaagtttgtcattctgaaaatgtatacttaaattacaatttacag	4TLS
attttaaattcggagttattagaaactaaaatattaaacagcaatttcataagcgtttcataatatttattttctttaggaaatcaatattcaagagtcgtttaataaatttctggaggagagcattgctcttcatcgagcgagaattggaattattgaattgattcggacaatacgagatggtgttttacgaattatcc	atttattttctttaggaaatcaatattcaagagtcgtttaataaatttctggaggagagcattgctcttcatcgagcgagaattggaattattgaattgattcggacaatacgagatggtgttttacgaattatccccgaagaaaatttagaactactgagacaagaagacggacaagaatcagccgtgctaagtcatct	4TLS
aatctcaacgcataatttatttaaagcatcctccgcccccgtaatggttttgtcatgaagaaatattaattatcccccttaaaagcgctatcgccagtaagttttgatatcttaaaattccccaaaaacattatcgattttttctgtgtgaatgaactctgaatggcttcttctctattaacttatgcgatggtaaacat	taattatcccccttaaaagcgctatcgccagtaagttttgatatcttaaaattccccaaaaacattatcgattttttctgtgtgaatgaactctgaatggcttcttctctattaacttatgcgatggtaaacatgtgtaattttctttgtaacataataaattattattattttaaattttttgcttcttatttttgctt	4TLS
ttccttcagttcggatcgcctgaaaattaacaaaatttgatttagatttaataattttctagcagttactcgttgcaggaaaaatgtcaattttatgaaaaatagtgtcctaaaacatgcaaaacttttcttttcagttaccgcaccagggtttactgtagattttcaagtttttcgtttaagcaaaatttcgtatgctt	actcgttgcaggaaaaatgtcaattttatgaaaaatagtgtcctaaaacatgcaaaacttttcttttcagttaccgcaccagggtttactgtagattttcaagtttttcgtttaagcaaaatttcgtatgcttttacaactacaaatgtgtgcagatcaggggtgtgcggcaaatttgccgaatttgccgagcacggcaa	4TLS
tttcatgagttctaaatctaaatctggacaccacctacaaaattataagtttagcataattgcagagatggcgaatgccaagcgcaaagattgaaataaatgacaaatactattgaaatttaaaaaattgaatcgtgcgatttttcgaaatgatagccactaaatcgctgaagcgaatgtagtctacaactttaaacttt	tggcgaatgccaagcgcaaagattgaaataaatgacaaatactattgaaatttaaaaaattgaatcgtgcgatttttcgaaatgatagccactaaatcgctgaagcgaatgtagtctacaactttaaacttttgtttaataaatgtttaataaaactcaaacttttgtttaagaaatacgaattcgcagaaaaacgtaga	4TLS
ttgaaaaaaaattattgtaagtgactcctcatgtaaaattcgcatatgaatattaggtcactttttgaatacaatcactacatgttttttgaattcaagtcagttggaacgggagaagaaaaaaagtaggtgaaacagacataaaacgcaagcgacggagaatatgttggcagtggtaaactttgacttttttttctatt	acaatcactacatgttttttgaattcaagtcagttggaacgggagaagaaaaaaagtaggtgaaacagacataaaacgcaagcgacggagaatatgttggcagtggtaaactttgacttttttttctatttgtataaaatttaaaaaaaaatcatgttccatcttgaacttttaaattgaaaataaaattgtgttttatt	4TLS
cacgaatcagagaatcttcgaattctattaaaccaaatagttcgttttgcaatttagtaaaatttgatgttcaattatgtagtttgcttctcccaactattttaataaccaattaattgatttcaacatatcaaatcaagccaagtctaagttgaaacaattttttaaaacatttattatgtacgggctgggtggcttaa	tcaattatgtagtttgcttctcccaactattttaataaccaattaattgatttcaacatatcaaatcaagccaagtctaagttgaaacaattttttaaaacatttattatgtacgggctgggtggcttaaacatataatttctacatttggaatactcttatcaaatcccttgcccccctctcaaaaatgaccttactct	4TLS
ttcttggaatgcgggatacttgaaaaccgacaattccggaataaactcttgattcgccacgtcatcatcatttgagaagctcgtcggaaactcagaaatcacaaaaagtgctctgagaagagcccgaacgaacggagtcggctgttgatctcgtcgaattgtacggaatagtcgaatacaataggtatgaattgttggtg	ttgagaagctcgtcggaaactcagaaatcacaaaaagtgctctgagaagagcccgaacgaacggagtcggctgttgatctcgtcgaattgtacggaatagtcgaatacaataggtatgaattgttggtgtgtagaattcattccattcttcaacactttgctccgaatatgctccacgctttgtcgcatcggtgagcacc	4TLS
aaaatcgaagtagtttttctgattattgcgaaaatgtgaatttgcatgctttttggtactcatcgtataaattctctaattgaagtgcacttattttcacttttattcctcaaaaatgccagtagcacttttaacagcaggtaaatcgacatatgaacttttgagttttagtttcattagtggtatcagtccgaaaaaaa	tctctaattgaagtgcacttattttcacttttattcctcaaaaatgccagtagcacttttaacagcaggtaaatcgacatatgaacttttgagttttagtttcattagtggtatcagtccgaaaaaaaaactcataaatcttatatcaaattgcactttccatgtttcggctgactataacaaactcgcgtcatggaaaa	4TLS
ttcttttactacggaattttctcagcttgttatttttattgatgagagattttcacataggattacttaggaaatatgagatctcaagaattcaatcccatacacacatgtccgtggactattcagaaaaaggttggcagtgaacattttggggggtttcctgctggtcaggggagcagcaatttccggcccgcaattct	aatatgagatctcaagaattcaatcccatacacacatgtccgtggactattcagaaaaaggttggcagtgaacattttggggggtttcctgctggtcaggggagcagcaatttccggcccgcaattctgcaaaattagcccgcagcatgacatgttctcccaatatttttaattcaaatgtagcatgtgtattttcggaa	4TLS
ctacgtaagttgttttgtgggtcgaaccgaatatactttattttatttcaggcgccattttttgcagttctcttccttggtgtaagtattttttaacattatccaacaaaaaaatattttttgactcatttaggttatattacacttttttgctttttcaaagcctaaagtaactcaacgtttcagatttacgccgtctt	tccttggtgtaagtattttttaacattatccaacaaaaaaatattttttgactcatttaggttatattacacttttttgctttttcaaagcctaaagtaactcaacgtttcagatttacgccgtcttcaatgttgtctatggagtggcgactttcaacgattgtgctgaagctaaagtagagctattgggagaaatcaag	4TLS
tcaaattgtacagaggaaagaatgtgtgtggagtgcaggaaatggccacgtctgcacttgttaactgattaaataatcatattcgaaattgtcttgtttgtcaaacgtgtgttcttttcatgtacttaattgtttaattttccgatttgttttcaaattgtctttaataaagtttgtatgtacttagtttcaaagtagct	taatcatattcgaaattgtcttgtttgtcaaacgtgtgttcttttcatgtacttaattgtttaattttccgatttgttttcaaattgtctttaataaagtttgtatgtacttagtttcaaagtagctttaattgagcaatcattaaaatccacgtaaaacatttcatttagaaagcagcaatacagtagataaaagtccc	4TLS
gtcgttggccgcgccgtagacgcggtcagcggctggtaaacgaataatcgaggtgtatgatgtgaaattgaaccagaaaaaaacaaacgaaaaaccaaaagcttccgaatttttcgaagttttgtcggctctttgatttgtcacaaagactttgtttggaaattgaaaagtgagttctttgtagactaagtaaacttgaa	agaaaaaaacaaacgaaaaaccaaaagcttccgaatttttcgaagttttgtcggctctttgatttgtcacaaagactttgtttggaaattgaaaagtgagttctttgtagactaagtaaacttgaaaataagtcatatttaaactatgttggtatatacatacataaattttcagttgtgaaatttcacaatttctaaga	4TLS
tgttgtcagtgatttggacatgcttcaagaaatgttcatcaagaaatttgattgcttttacgccagaaaaaccaccaatcttatccatggaaatctcgaatgctcacaagaagagccaagagtaaatttattcgctgctcgtggagccagatggaagcgattgagagccttggcgtctcctgcattttcagtcaaagcat	caatcttatccatggaaatctcgaatgctcacaagaagagccaagagtaaatttattcgctgctcgtggagccagatggaagcgattgagagccttggcgtctcctgcattttcagtcaaagcattgaaacaggtaatatttgatagggagtatttaatatttttaatattagtttggtttttcagattcatgaaactat	4TLS
tttattttgttccccagcactttaggatattccccctaaagcaagtaagctgtgtaaatactaccaggtccattataacacccgcagaatacccgagaaaagtcggcaattgcaaacatgtggggaagagaccaaagaatcaatgtactttcttttgaatgcgtctgtgttttgatgagttgaatgacggagacgatgac	acacccgcagaatacccgagaaaagtcggcaattgcaaacatgtggggaagagaccaaagaatcaatgtactttcttttgaatgcgtctgtgttttgatgagttgaatgacggagacgatgaccttattcgattagaaccacatggtttcgcactcctgttattagtgaaattatgtccgagagtatttggatttgagag	4TLS
ctcctctgccacgtcaaaaaatgaaatatgctcgctttcctgaatctctgcgtctctgagcacttcccaattgcgccgtccatatttcatcgtgcacgaacccgcggagcacacgatatgggctagagaagaagaattcaaagaattttaagatgatgatgatgacgatgtcttgagggacctacagtacttcttatcgg	ccatatttcatcgtgcacgaacccgcggagcacacgatatgggctagagaagaagaattcaaagaattttaagatgatgatgatgacgatgtcttgagggacctacagtacttcttatcggagaagtacatcgaaagtttgaaaactaccgtattacagtagaaagtcgataaattttcaaacgagcggtccagtgactg	4TLS
gaaacttgaactaaatgaaggagcgaaagaaacaactattaagaaataagaaatctgacaaattgctaatcgggaaatgcaagaaggatgattatagttgctaggtcagggccgttccatcaactatcttctttttccatccacctcaaatgaaatagataaaatcagccgcagctagcaccgccactagcctgcgatag	aagaaggatgattatagttgctaggtcagggccgttccatcaactatcttctttttccatccacctcaaatgaaatagataaaatcagccgcagctagcaccgccactagcctgcgatagggatcatgtacccaattttgagtgatagatacacgtaattgcaccttaaaacttattgacattcaattgatggacaccag	4TLS
gatgttttaaatcattagtatgattgttataaaagtctgaaattattatatatatatataaactaaaaatattaaaaaatataacaactcaccattttttatacgaacaccgtccatttgattcgaacaccgaccagtgaaagattcggaaataaattctaaattctaaactctaagaaaattcttttttttttatttag	taacaactcaccattttttatacgaacaccgtccatttgattcgaacaccgaccagtgaaagattcggaaataaattctaaattctaaactctaagaaaattcttttttttttatttagaattttttttttccaataaatttcccacgttttcccagaaatgtcattcaaacgtgatttttataaactaaattaattaaa	4TLS
ggaaattttgcaggccaccatgagtttttgatgcagttgaactaagttagtggcctagaaaaacctttgttagcctagaaatattttcgccggcctaaacacatttttggtggcctagaaacactaacttttggtagcctaaaaattttctgtgacctggaaacattgttggtggcctgaaaacatttttggaggcttag	attttcgccggcctaaacacatttttggtggcctagaaacactaacttttggtagcctaaaaattttctgtgacctggaaacattgttggtggcctgaaaacatttttggaggcttagaaatattcttggcaatttgaaaacatttttggtggcctagaaatatttctgatggcctagaatgtttttgtggtctataaat	4TLS
gaactatttgtaaaaatcaaattcccaaacgttttgaaaaagcccacacagcacaacacaaacattgatagtgattatgtcatttttgataagaaataaaccttaaaattcaaaattcgaatcatttattgaggaaaagcaccagaaatcgatggaacaacaacgcaaaaagtatggaaatggggaacccgtgaaatgtc	ttttgataagaaataaaccttaaaattcaaaattcgaatcatttattgaggaaaagcaccagaaatcgatggaacaacaacgcaaaaagtatggaaatggggaacccgtgaaatgtcagctgcttttggttttttttttttttgagaacttgtttaaaatgggtatccaaacacgataaagtcgtgttcgtacagataac	4TLS
aacacatttgtgctcgatactctgattctcacgtgatctgctcatgcttatatttcctacctgatccgaaattaacgtatgcgctgatttttcctgtgcttgtgtcactggatctggctcgtctgacggtgctggaatagatgactcaacgctatcctcatcaccttgtacttgttcttcatgatgttcggccgcaacat	tgatttttcctgtgcttgtgtcactggatctggctcgtctgacggtgctggaatagatgactcaacgctatcctcatcaccttgtacttgttcttcatgatgttcggccgcaacatctaagattttattttccagctcttccttctcttcttggtgctccagcggttgttgttgagactcaacagctacctccgagtcac	4TLS
tccattcatttcttttccattacgcaatcgggccaaaccgctatcacagtacctcatcttaaggtcattccctctcagaatcctcagataaaaatctcgaaaagccgcgctctgattggtactgaatatcttgccccgattccactcaaaacccgacacaacacatttatctaattctatttgaagactcttctggcgtc	gataaaaatctcgaaaagccgcgctctgattggtactgaatatcttgccccgattccactcaaaacccgacacaacacatttatctaattctatttgaagactcttctggcgtcgtgccaagtatgccgacaaaccgttttccaaggacataacagtcgttttttgtccgtttttgaccattttttccgtttttataatc	4TLS
gttttggaacaaaatcacaccaattgctagttttattatgctaattctcccgtttgccggtctctggaacattatgatatctcaagttattgcatcaagtgtacgcggtggatttggggtggattatataaaagcagtgaaatgggtaactaagataggcgaaaaccggcaaaaaaaacccagaaaatttcaggcttcac	tattgcatcaagtgtacgcggtggatttggggtggattatataaaagcagtgaaatgggtaactaagataggcgaaaaccggcaaaaaaaacccagaaaatttcaggcttcactgtcactgttccagtccatctgcatcctgactgctttgggcttcacaatagtttgcacctctgtaacattttacaaactagcatgtc	4TLS
tacaactgtagaacgaaacgcgctaatggaggagatttatccaaagcttaaggaatactgccgtgagacttatggtctggattttcaggttttttttttggatttttatgaaagtttttccgatggcttgaaacccggaaattttgtctacttgaagcccgatagctgtaaagagtgaaagtccggtaattctgaagtcc	ggttttttttttggatttttatgaaagtttttccgatggcttgaaacccggaaattttgtctacttgaagcccgatagctgtaaagagtgaaagtccggtaattctgaagtcccgaagttctgtatgtaggtttgaagctcagtagttctgaaggtttgaagtcccgtagttctgaaggcttaaaactcagaagatctga	4TLS
atctgtaagaaatcatttttattagggaaggggcgatgcaaatatattgagcaaaaaggagaggtatctagacagaggtcataaatggggatatgggaaaatatgactgtctcactttatgacacggcagaaaaacattgaatgtgcaaataccaaatcaacattagaaaattttagaaagtaggctcatggcctcgcca	ggatatgggaaaatatgactgtctcactttatgacacggcagaaaaacattgaatgtgcaaataccaaatcaacattagaaaattttagaaagtaggctcatggcctcgccacgctcttcaaaaatcaatggattgcgcgtgacgagaccatttcgcataaattcgtcctccttcaaaatcgtagaagtaaaaaaaagta	4TLS
ccctgtgattttagacgtcaaattcattttattctcattgaaatagctatgcatcaaaactcaaatggaagttgtaaacttgactatcaaaagttccaaattaccaggaacttctcaaaatgtgacatcatctatcttcatctgctaaataaatgaaactcttttgaaaagatggaaagccgtgtgcaagcgaataagat	aagttccaaattaccaggaacttctcaaaatgtgacatcatctatcttcatctgctaaataaatgaaactcttttgaaaagatggaaagccgtgtgcaagcgaataagatttcttggaaaagatatgggtttctcacgtcctcgagaaattttgatctagaacagtagaagttgcgagttcgagtgaggatagcttaaaa	4TLS
caagcagaaaataccccgagagtctaggtctccagtatctgaagcgtcaggtcacatgatctattattattattaaaaaaagatacctctgtgctccagttgccactgatctagttgcaacagttccccttgtttgtggctgagagtaagcttggtgcaaagctcgttgtcttctctgatactctgctggatcggtcgga	tgctccagttgccactgatctagttgcaacagttccccttgtttgtggctgagagtaagcttggtgcaaagctcgttgtcttctctgatactctgctggatcggtcggaccgacagactgtgagttgaatggtccattgagtggaagattcccatttgcagcgattcttcttggaataatctgttgcacaacttgtttgc	4TLS
gcgctaatctcagaactcacaccagaatttgacattttttaaatgttgtggacaacgacaccaggaagcggaagtaacagattttatagattatatgtcctcactacctggaaataaagtacatttcgagaataaaaaagaattacaaaaaaagaagtagaagaaacaataaaaaaaaagtaaagagtagtgtcagaatt	atatgtcctcactacctggaaataaagtacatttcgagaataaaaaagaattacaaaaaaagaagtagaagaaacaataaaaaaaaagtaaagagtagtgtcagaattgaaaagagtcgagccagtgttggaaaaacaaaatactactgttacaaatatgccaaatcacattgaaaaacttttcaacacttctttgaact	4TLS
cacaggtgctccctttctccatctcatttttcccatcttcgcgcccgcccaaagtgtccctgtgtcccttgcgcgaattgtccagatggtgcccttttctctatctctcactttcccttcactgtcacaagcatattccatttctctaaacttttttctccggtgtgcgacggaatggtcaattgatgaccgatttgcag	tctctatctctcactttcccttcactgtcacaagcatattccatttctctaaacttttttctccggtgtgcgacggaatggtcaattgatgaccgatttgcagctcgccgcataatcttcctatttgacaaatgaattacctccaccctattcgcggatgcttctcttcggtcaagccacattgttttgcaggcaatttg	4TLS
gaaagtctcgtatttgaaattgtatatcaaccaatgtatcccagcaattacagtaaatgtgaatttgatactgaaacatattttacctgcttctcagaaagttggaacttactatagggtttctgattattttaagaattttgatagcgtccaactcgattttttccagatgaatctgaaaccaaaaatacgtaagcaaa	aaagttggaacttactatagggtttctgattattttaagaattttgatagcgtccaactcgattttttccagatgaatctgaaaccaaaaatacgtaagcaaaaagcagaaaccacatgcaaatttattttgatgttgaaaatcagtttcgaacaaaaaataaaataaaataaaaatcgattacctaacttgaaaaatca	4TLS
gcctacgccttataattttcattgtttccacattcgcggttccatctccaaaattttctctatatgcttcaaaagttgggctaagggactggccgcatcttcctccagtctacacgtctgaaggctgtaactacctttatagtcggagaagatgccacataggacgacagatttggtactgtgacgatctgaatagggta	cttcctccagtctacacgtctgaaggctgtaactacctttatagtcggagaagatgccacataggacgacagatttggtactgtgacgatctgaatagggtacgatcgtgttttagatcaagtatggattctgatattaacaaatgaattgtgcgtaattatgaatttaacttttatatattacgttgcaaaataatctt	4TLS
ttagagatagtgtagaaattgtgtcacggtggagacatagagacgaggaattcataaatgggacgagggagaaaaaaactgaacggggatatagttgggctaaaactaaataactaaatagctaaaaactaactaaaaactaaatagaaaacacatttattttgtttactttgaatattttaaattctaatccaggggtg	gctaaaactaaataactaaatagctaaaaactaactaaaaactaaatagaaaacacatttattttgtttactttgaatattttaaattctaatccaggggtgtgtggcaaatctcgaaattgcaagttgggcaaattttttttttttcaatatttgccgagctctgcaaacgttaaattcggcaaatttggcgaatttac	4TLS
tctactgcttttggaggcaatggagaaagtaggaattgagaaccttatctattgcggtaagatatacgctaaaaataaatatttttaaaaaattatgacttcttttcagatactgactcgctaatcttcaaacaaatccaagggatggatccactgggagacatgaaaggcacacagctaggagctctaaccaacgagat	ttcttttcagatactgactcgctaatcttcaaacaaatccaagggatggatccactgggagacatgaaaggcacacagctaggagctctaaccaacgagatcccagaaggaaagaagctagtagaggtagtgtgtatgacaccaaaggtgtattcactaaagatggaagatgttaatggtgaattggactacacagtaaa	4TLS
ttttcaaatgctacggtagtattgatcaatgtgttcatagaccactcatgacatgttacagaatatttgataatggtagaagtaagatgtataatctcaggagatttctatatcatgattctcaaaagaaaaaaaaacaactagcactaaaaatctcttgggagaaaacacagtatgaaatgtctaattgaccaatgcgt	gagatttctatatcatgattctcaaaagaaaaaaaaacaactagcactaaaaatctcttgggagaaaacacagtatgaaatgtctaattgaccaatgcgtgagattcagaggaggatattttaaattagtaaaaaatatcattgatattttgggaaagaagcagtaaatagatcgatagagtaggtgtgttggaattttt	4TLS
cctgatgcttttatatgtagattgacgttttttctagcttaaaatgacacgtggtgccaggctgtcccattacggctcgatctacaaaaaagcgggaatttttctcataataaactgaagcttccattttgagttgtccaatttcaaaacaatttcagagctgatttctaagaaagtacatcattggattggaaatagac	ttctcataataaactgaagcttccattttgagttgtccaatttcaaaacaatttcagagctgatttctaagaaagtacatcattggattggaaatagacgacgcccagattgcccaggtttttatttccacagcgacccaaaccaccaatgcggtcataataaaattcacgaatggctcaacaacgttgcaactgaagac	4TLS
agagaaattctcaagattttctcggtaatgttttttttgttagagcatagatatattggttgttacaatattatttttataatactcaaacatttttctcgacacccgtttttccttaagcttaaacgcggcattatgtttttattatctatttcacttttcccaggcactccgttttcattaattgtcttcctcattgt	acacccgtttttccttaagcttaaacgcggcattatgtttttattatctatttcacttttcccaggcactccgttttcattaattgtcttcctcattgtgttcgttttgtggaacggttcccgatataaattttattcaaaaatcagaaaattaaaaaaacagagagaccgtctgccagattgggctatcgggacgaaga	4TLS
tgccatgtaaatgatttcacgaccgacaatgttatcaacgacagacagtccgaatccttggagtgaaatttctgcttgcatatcaacaacatcagtttcccaactaccgtacgctgctttggcaatgtcaacatccggtgtgaaaaggagaactcgctgtcttcctatcaagaagtttgaataatatgagaatctgcgga	actaccgtacgctgctttggcaatgtcaacatccggtgtgaaaaggagaactcgctgtcttcctatcaagaagtttgaataatatgagaatctgcggacactcttatcaatttgcaaatcgccaaatctattctgatcgagtttatcttcgaaatgccaatcaccaatatctacttcaagaaccttgggctcaataatac	4TLS
gaggaatacgagaaattaagagatctatcgtagatacttcacttgaaagtcgagtgagaaaacttgaacaaagttcgttatattctatcattaaaaaatcatcatcaaaagaatcagttgttcattgtggtaaaccaccactcgaaagacaagcaagtcttgaaggaagattccgaatggaagaaagttggtcagcagtt	catcaaaagaatcagttgttcattgtggtaaaccaccactcgaaagacaagcaagtcttgaaggaagattccgaatggaagaaagttggtcagcagttgaatgtaaacgacgttcatcttccattgatcgtgcatctctgaaacttagagcttcacaagaagaagtttgtactggattctggaacacttcgaagggagaa	4TLS
aatgaaagcgaaagtgggttcgctttggcgattacaaggaattctgaaaatagaaagtaaagtattttattagtgaaattaaaagttggcgtgaaattagcctaataagtatttccaaataaaaaacactgctttaaaggtggagtagcgtcagtaaggaaattgttaaaaaccactcctatggtattaaagtgaccaaa	aataagtatttccaaataaaaaacactgctttaaaggtggagtagcgtcagtaaggaaattgttaaaaaccactcctatggtattaaagtgaccaaataacctagtaaaacttttcaaaatatgtttttaatgtttttatttcgactcaaaaagccgtgaaaactggttttttcccaaattttttgtagccgtggatcga	4TLS
aggtttgtattcgaaattttgtgaaaattaacattcaagaatatatcatattatttttcaaaatttatcattttataatccaaaaactaaagcgtatatactgttttaattttagaatacaagtttcctaataatttttctttcagatgatggacttaccgtacatgtcgatggcctgagcccaggaacgaaatacgatg	tttaattttagaatacaagtttcctaataatttttctttcagatgatggacttaccgtacatgtcgatggcctgagcccaggaacgaaatacgatgttcgtgttgctgctcttcaagttgatccagaaggcggtgaaacgacgaaaacgttgtctggaatctcaaaaatcacgacgacgggaacgagttctcgtgaaaga	4TLS
actgtacacacgctaggcaggcatttaggcaggtaggtatgaacctcggttccgtgaaaggtctagattaaatttttcgaagcaaaaattttaaagcaaatgattgaatcccaaaaagttataataatcatcaaaagcacatgaaattttcgaatgttgttcaaatcctccgaacagcctgcataacaaatatagcatac	gaatcccaaaaagttataataatcatcaaaagcacatgaaattttcgaatgttgttcaaatcctccgaacagcctgcataacaaatatagcataccagagctaaagtttaaaagggtagagttcaaaatttaggaaatttccgaagaattttcaaagacgtaaatttgagaactgcctactttgtaaattttcaattcct	4TLS
atccttgattttgatgtccaaataattgtagacaatttggttatctgtaaatatagcatgttagcttgccattattagtttgtgtcgcgaatctcatttacccgactaacttctgttaataataaaaaatatacaaaataaatgaaatcaaccgggaaacaacctctgcaacctttacgtggaagttcagatgtctatgt	taacttctgttaataataaaaaatatacaaaataaatgaaatcaaccgggaaacaacctctgcaacctttacgtggaagttcagatgtctatgtagagagaaaattgtggaagagacattagttccgtgtgagaacgtacattttttagaaacatcgcaaatggtattccatgctttcacaatatctccatcatgacttt	4TLS
aatgagtaatcaggtaatttgcctgtggtgaaatgtggaagaaatgtgaactcacaagcaagtccaccgcaggaccatatacatcccctatgctgccgacgctacgcggtacctcgcgccactatagctgtgtgcaacagagaagggcgatggcggcgggagcgtgaggcgtggtgtgaggcggacgggcaagagtagcg	cggtacctcgcgccactatagctgtgtgcaacagagaagggcgatggcggcgggagcgtgaggcgtggtgtgaggcggacgggcaagagtagcgccccttgttatttttgttgtggctatctcatcgaaggaagggcaggagccttgtctacaaggtagatcaaaaataaattatgagaaaaatttgcgatcgtattttt	4TLS
aatgggctaaatttaaattaaattagaactgagtttgtctttgtgtattctggcaaataagtttttactagtatgctaattataaaattagaaaataaaaccttttctaaactatctaaaattcagcaaaaaattaacaatttctctcaaacaactcaaaaaatatagtttcattttctccggaaattttgcctgtacaa	taaactatctaaaattcagcaaaaaattaacaatttctctcaaacaactcaaaaaatatagtttcattttctccggaaattttgcctgtacaaacctatagactacattcctaatcaatgtttttttaattaaaaattattcaaagcacgaactattcaacaaaaaatgcacaaaaacacacacttcataaaaacaataa	4TLS
aatatttttaaattatactaaaatctccattttcagtccgtaaaatgtcattcaccaaaaatggagatcaacaaaggcccttgaagaaagttggtggaccatttggaggagtccaaggaggatcgtttggaggatttgcggagaccaaaggcaatggattctcttttgaaaaaactgccgaagttgaatccagcaaagat	agtccaaggaggatcgtttggaggatttgcggagaccaaaggcaatggattctcttttgaaaaaactgccgaagttgaatccagcaaagatcaaccaatgaagaaatttaattttgatgttcaagactcggatcaatcaggtctcaaatcgaaagttgtatcggattcctatgagtatgataaagtcatgaagactcttc	4TLS
agagaagacctgcttaacacagtttttctccgcagttgttgcgctagaaatgtgaaaaatttcgcccgcaaagtatcgaattttgagaagatttgaagaatgataccctttcaacaaggaaaataacttaccggcattgttaaaatttcaataaatgcataaataattgcgtatattgaaaatgaaaccatcaaaactct	ttcaacaaggaaaataacttaccggcattgttaaaatttcaataaatgcataaataattgcgtatattgaaaatgaaaccatcaaaactctgtatcttccgaaagaatttccggcacgaacttttatgagataaaggagcaataaatttgcagttgttgcaatagaaaacgctgacaattgacatatacgaagcagtggg	4TLS
gtatgcaatataggtttgcgctcagtcgtagactggcggatggggatttctgagttttgagactgcaaaatttaaatatatcattttgataactttgaaatttcactcacctccgacttcgcgcccacgaatgaaagttggaaattctcaattggtttgcatactccgttaattttgaagcactgtggtggtgatggatc	cgacttcgcgcccacgaatgaaagttggaaattctcaattggtttgcatactccgttaattttgaagcactgtggtggtgatggatcaatcgcctcaattttgacagtgacctaaaaaatgaaacattagaatttttgctgaaaaaaaaagaaatttacctggaagtggtttttcttttgattaacaaagcagttatcat	4TLS
tcttcgattcggggtcgcagttgaactgaaaattttgtattagtggatctctgagttttgacttttctcgaacttcttcgcgatgaatgtttcgttcgcgttgttctggtaaagtaagatggatgtggtactttctgtcgcccgctatcgtgccaaaggcatgtatgtataaacaggcatgggtaggcatattggaaggt	taagatggatgtggtactttctgtcgcccgctatcgtgccaaaggcatgtatgtataaacaggcatgggtaggcatattggaaggtatgctaagtaggcatgcatgtagagttctaggcaagtaggctgacacataggtaggcagcctactacttacatgcttccgctcgctaaacacatttgacggccgctacgcgctc	4TLS
tttttcagattttacagccatgtcgtctgaaaaggtgcttcgatgtgggaatgagcacttccagtgagattttttttaataatttactttttatccagaaaaatataatattatctagatttccaatacaaccgagacggactcaattcgctgaaattatgttcaaaaatacctcaaaccctggaaaaattcgtcgggag	ctagatttccaatacaaccgagacggactcaattcgctgaaattatgttcaaaaatacctcaaaccctggaaaaattcgtcgggaggcctgaagttgttttattctgggattcgcaaaaaccaatttgcaccagatatatagatgtcagccacttgataaaaaaggctttaaatattttcaggctcccttctgaaactgt	4TLS
tcgaaaaaaaaaattttttttttgaaaattggattttttttttaatttttcttacaaaattcaatcagaatattttcaacaaaaaaattaaaatatttcagcaagcctccctcctcctaaaaattattttcttgcaggcgccggtgctccaatcccacgacaagtcgaatgttactcgtgcatgtcgctgtcttaccaga	aaaaattattttcttgcaggcgccggtgctccaatcccacgacaagtcgaatgttactcgtgcatgtcgctgtcttaccagactagttggaaatacttacaaactacgtatatttatcctaaagtgagtttttagcttgactgtcgatgaaaaagattttttaaaaaatttgctaaaaaaaattttttttttcaaaattt	4TLS
cttcaacgaatctttgtcccccatcatttgtcccttcccgattaccaactgttccttttcttcttgttgtcgccgtttctccgccgatcaccgccgctatttgcatacgttcgtcaatttcttgtccgtcggcagtctccatttctcttcgggtatccattatcgataaactttcccacacttgataaatatcctcgtat	tcttgtccgtcggcagtctccatttctcttcgggtatccattatcgataaactttcccacacttgataaatatcctcgtattgctctttttgtagaacacttggaaattgagcaaatttcgaaataaattaaaattgttgttttgaaagctgtggatttttttttggaaatttgagggaggggggggggggcagcgtgat	4TLS
ctgccaatttcgcttcaggacctccttcctcctcagtctcctgacgaatccgtcctttcaacgccatcgatgaagattttacgcattttgaggagcaggaacaggcttctgacaggtcaaagagggtgatgagaatcagcaaacaaatcaccaaaagtttcgaaaactgtggattaaaaatcatgatttttcttcacatt	aagagggtgatgagaatcagcaaacaaatcaccaaaagtttcgaaaactgtggattaaaaatcatgatttttcttcacatttggaagatgtctgaaattgatttttttaagttaaaaaaatagaaaacaaagaaaggagcaagtgaaaagtttaaaaaagaggtagtagctgagtacataaacatgggaaactgatatcg	4TLS
atgccatgggctcttgacacgaactaccatgtagcacttgtattcaggatattccaaggaatcctctactctgctgactttggagttgtcggatacgtgtgctcaaagtggtcgcctatcaaagaagtaggaatgtcactggctgcgttgagtggattcactgcggcaagagctgtaattcagttgccactggcaggatg	aagaagtaggaatgtcactggctgcgttgagtggattcactgcggcaagagctgtaattcagttgccactggcaggatgggtaggttattgcactgagacggtatatttaaaattcataatatttcagacaacatcaaatgttggctggcgacctatctattatattctctcaataattctcttcatctcaacaatcatc	4TLS
ataaaagaaattccgcaaaaaaatagtgttcaaggttggagagacggtgtgagtgtgtagaagcgtttgatcgacaaataaagttatcagcaagtacggagcacaagttatgtcatagtctgtatctatctgtttccccccatcacttgtcgctctctgaacaactgattgcaagatggggaggaatcgaaaaaatgaag	atctatctgtttccccccatcacttgtcgctctctgaacaactgattgcaagatggggaggaatcgaaaaaatgaagggctcaccggatggaagaagtgggcggtcaccgaagaggaataggtggcggggtggataaagacctcggggtgcgagaacgtgacaatcagtttgccatttttgaagagagagggtgacaatg	4TLS
tcctccgggaggtgatcgaaccaaatatccgttgacattttatatttcctttcacacggttctggagttggtccaggttcagtaaaccggtaaataataattccatgtccaaactggtgaccgccacgttccacgtaagcaacttttttttgaagacgcaaacaccgggatgaaactgcagtacacgttcttaatttaaa	cgttccacgtaagcaacttttttttgaagacgcaaacaccgggatgaaactgcagtacacgttcttaatttaaattcaaccgatttcatagactggttgtttcctgtgacgactcgcagctgattctgacaactgtaaacaagtggaacgactgacgacttctctcctgctgattcacctgcaataattggaatttgcag	4TLS
atgtatttgtttttctttggagccctcaaccaacgtcatttggaccattttgacatttttctcagcttaaccttttaggattttgtcgaaaaaaaacaacaaaaataaataaaacctatttggtcatttcaaaattttttaaggaatttttttaaactgaaaatataggaaatagtgtctggaaaaatccaaatttctga	ttcaaaattttttaaggaatttttttaaactgaaaatataggaaatagtgtctggaaaaatccaaatttctgaaaattaccctagtataaatgcatctgaaaattttttgtaatttgttatttattttcccaaaattcgaatccctaaaacgtccaaaactccatccagaactttgataccaaaccgaaagcttcacttt	4TLS
ggatcaagatcaaaccactcttctcggttgatttcgtatttctgaaataactaaacaactgcattaatttctaatctatatatgtacttctatagaaatcatacacttgatgggagagaagtactctagtgtgatttcaaattcattctacgattattttattcaaaaaaaaaaccaacctgtccatttgaaatcagaaa	tgtgatttcaaattcattctacgattattttattcaaaaaaaaaaccaacctgtccatttgaaatcagaaaatgatttgaagatctagattttgcgttgtaccatgaaagattgatagatctgaatgtgtcaatgggtcctagaaatagtatgaattttataaaaatccagcaaaaaactcaaaataccgtgatcttgaa	4TLS
aaatttaaagtttcaatttttagtaatcattcagtattcaactattttaaatttggaaaactaaatatcaatatacatttggagtcctgaaaggatccacactcaaaacctttcagtacttcattagacgagtaactgatttcgtggtccgacatctactgggttccgcacggcactatatttaccttactgagggcgtg	gagtaactgatttcgtggtccgacatctactgggttccgcacggcactatatttaccttactgagggcgtggatcgttactgcaaagtgaacattgtgcgacgctgagttagtaagtagggaccgtttaattttgaggttttcttgacaaagaacaacaaagttttttagattttggattttgtacattcacgctttata	4TLS
ctttatatgctaggtatgtataagtttctaataagtgtatatacctaccatgtacctagggggagtagagtttgtgggtattttgcttaaatagactaaaacgtgtccaaaaccaccgaatttcaaaatgagacttcacaaaaaatttccaaaattttttttatggaaaaaagagcaaaatttaactaaaatccgaaatt	ttcacaaaaaatttccaaaattttttttatggaaaaaagagcaaaatttaactaaaatccgaaatttcgcacagttttctttgtcacagccgctggatttgaatttttctgaaattatcaccctttaatccttattttaataatttatctcgcggaaattcgttgattgagacaacttttaggccgataggcatcccatc	4TLS
gagcaccacctgtctcactagtcaatttgtcggatgaagaggtgagactttttgattctcattccgaaaatagaagagtaggtggacaatgaataagtaaaaagttttgaaggttgtgtaaaaatgatttcatctgacaatccacaggtgtcgatgtatctaaactcgattgaaaatataatttaaatgttgtttttggt	tgacaatccacaggtgtcgatgtatctaaactcgattgaaaatataatttaaatgttgtttttggttggcaatttcagagttatcaatatgaaaaagcttaaacttcaattttcagatcgctgagcgaaagaaacaacaaaaccgtgcagctgcactccgataccgtcaaaaacttcgtgaaagccgtgtaatgtcagtt	4TLS
tttcggaaacttgatcaagaatattgatgaatggtttattgagagcaaccaataccgctgacgagaactttaccatttcgatttggtctcccgaaatagccttagcttggaatttaatttgacttggacggaacaaacatttcgccattttcatcgaagtaacaccgttcacaagtgcccatttacgaatttcatccaga	acatttcgccattttcatcgaagtaacaccgttcacaagtgcccatttacgaatttcatccagaaagggttcaatagcgatgactcctttatttccgcggaatcgaatctgcaaaaactatagttacctaagttcacacgaaattaatttacctggaagcagctaggaacagcttttccaaattgcatcgcttgggatac	4TLS
ttttcgaaaatttagaaattcggcgacaaaaaatttcggcaattaccgggttcaaaactattagaaaaaataactataaaaattaacaaaaaaaatcaatttctactgtagtaaatgtgtttttgatgaagaaatataactcaaaacgacctgaatattttcaattttctattcggtaattggaatttatttttgataat	actcaaaacgacctgaatattttcaattttctattcggtaattggaatttatttttgataattcgaaactttgacaactgctgaattttgaaaaactcagcgatcggcattttgacaattgcctagtctcaacattattccggcaatatccttgtggccgaattttcggaaattcgttacctggaacgcgtcagtatttc	4TLS
cgttcgatttgacactagccaatctgcagaaatatactacagtgataacttcaagtaagtgtttatacatgtgcaagaatatatttatccgacatttttagacagttcaacacatcagtgaatgccaaccttcccgatccatctcttggatttaaaagcagttcaattggtagtgactcgttgaaaattgttgaggtaaa	catctcttggatttaaaagcagttcaattggtagtgactcgttgaaaattgttgaggtaaacatccgaggctctagagagaaggttccggcgaaggcgatgtttcagcgcttctgtcgatgcttctgcttttacatatcaaaataatctcatttttagaatttttacgacatctcaccattctctctttgcggctctatt	4TLS
tcacatcgatattcggtatcaggggcaaaattagagtcagaaacatatatttccccacaaactctactccccctttaacctttcaataagcggaataataccttcttgctttttttcgagaacggattaaatttctttttccaatttttccaatttttatcttttttctcgtttcgattttccatttcaatttgacgagt	ccaatttttccaatttttatcttttttctcgtttcgattttccatttcaatttgacgagtatgaaattgtagaagtatgaatctgaaaaatttcactgggaaactggttggagtaaagtgaagtaaggaaaagttagtaagtggtccacaacaattattaatgttaccaatcagtattgattatttcatcatgattacaa	4TLS
tcaaagcatccacaagcaatggaaaacgattcgctgagaggatccgcagctggcagcagcgaggtaaggtttttgtgtatttttcgtcctccaaaattttaatttaccaaattattttcaggaacccaatcagaatgggaagcgagaagatgatcaagtagaaggaagaaatgatgaggatgatgtactagaagatgtcg	gcgagaagatgatcaagtagaaggaagaaatgatgaggatgatgtactagaagatgtcgacaatgacgaagagcaagaagaagaagagctggaggtgagcagttttcaatctttaattttatttatcgacaaatagtttctacaggaattttaaaagtttctacagaaaattttcctattaaaaaaaatacggtttcaag	4TLS
aaaaggaaaagaaatatgagaaagagaagactaaaagcgaggattgataactacttttgaaaaataaacttgagcgacagaattgttttttttttaactttggaacacaaccaaaactgaaaaagagtttagattgatatttgcaaaactgaaactttgaattgtgctgattcggattaagcaaaaaacatgcaaaaacg	gcaaaactgaaactttgaattgtgctgattcggattaagcaaaaaacatgcaaaaacgcgaaaaattgagagaaataattatctagttgtccgagaggagtacgcgattgcgcggcctaggaaacttgcgcggaagtttgaataataattagccacaaaagtttttctggtcactttggagccatgtaactgtcttttga	4TLS
ttcgagagaaataattttcggggagacaaattatttttcttacataagaactccaacacattcaaacatttttgtaatagaaatttgtatctcagagcactcgaagtaaattgttttatagttttcctgttagggcatcaaactggaactacacaactttgctaataattattttgtttaaaaagagttacttaaaagat	ctggaactacacaactttgctaataattattttgtttaaaaagagttacttaaaagataagtacgggtttatgtacatctcttctctgacaaaataaacgtccgtattttccctatgctcctcacttctatactttgagcgcttatatctctgttgtttttaactttataaaaaaatgttcaacaaccaaaatatagaaa	4TLS
aatagatttcaaataggacttccacgaaggcatatgtatattacctctgtgtacttttgccataacttacgcgcggtggtattgccacgcggaaagcggataacagtaactcgtgtcgatcaacaattgcagcatattattcaattttaatattaatgaaaattttaaaaatacgtgtaaacactatcagaggcccttag	aattttaatattaatgaaaattttaaaaatacgtgtaaacactatcagaggcccttagattttacagtaattcgttgtccgcgtagcgagaccttgcgcgtaagacatggcgaaattatcatctttagaagtctatgtcattggaaagttggtaaattaaaaccacccgaacttctaaaacttcttaaattccaaataac	4TLS
aaaaagaagaaatatctaattttattccttttgaatatttttgagtgctcgtgacctctggtgccccctctcacaaatgacatagagttcaatggatccattcagttttggattagagcagaacgaaaatgggaattatttgaaattgtatctcgtagaaaattttcaaaatcagaaatcaaaagttcaccgcaactcct	aaattgtatctcgtagaaaattttcaaaatcagaaatcaaaagttcaccgcaactcctgactcgcatcacccgacctgctcaaattaaattttgcctttcttctcaaaacacgagagcacaattttgggtctcaacgaaaaaagtggagctcctaatagaacttccttccaatggcagtcagtagacttttatgactatt	4TLS
tcaaggtcaggcaggcaggcgttttaacgcctacatgaaacgcctacaaacggctacagtgaagttattacagtataacatttcgtattttcagttttttaaatcgttattaacattttccctaaaaatgtcccaaaaacatttaaatggttatagaacacctacctacaatttcaaatgaacccctaacgagtatggat	aatggttatagaacacctacctacaatttcaaatgaacccctaacgagtatggatataaaatcatggaaaagtaagaaaactgaagcagttattcttttgggaagtcagtgaaaagtgagcggaaatccagttcgattaatttcggatgatttacagcagactctcgctctccgccttttagattcggaaaaagggaaga	4TLS
ccaaagaaaatcgagatatgttgcaggggtggttgccgtttgccggatatcagatttgccggaaatgtttagagggttttttacaagacgggaacacatttttcccgtttttttctagatattgtcacagaatttgcttacttatcaaaataaatgttctgtaatttccaaaaaaataagtgcaaaaccacaatttgccg	aataaatgttctgtaatttccaaaaaaataagtgcaaaaccacaatttgccggaaattttcggcaaattgccgtttttccgacaattcttgccggtttgctggtttgccggaaatttcaattccggcaatttgccgatttgccggacgtcggatatgttgttctctaggagagtagcattaaaaagaactcttctaagtc	4TLS
tatctttcatatctaataaattcttgctagaaaaacccattgttccgaataattggatattgaaccgaataattgttgactgaatcatgatcattgtacaaaccctaaaagatcaatcattacacagattttcaagtgaaaaaataaaattgaaaaagaaaactattgtaaaaatccgtgattcaacgtggccctaaaat	ttgaaaaagaaaactattgtaaaaatccgtgattcaacgtggccctaaaattaaatgttaagttccattctccattgtattcctcgtaaaacttttcaagaacatttcccgaatttttgcaaatggaacctgaatcgattctcgactttcataccgaacaggaagaaattctggtaaattttttatttttttatttttca	4TLS
cagcccaacgagacatttgaaaattcagaatttttaacaaaactttgaaacaatgtttgttggaaattatagaaaacaaacaagaccggttttgaaaaaacagtatttacttctttgaatatttttaacagtttgaaatagagaacttggagcattttttttttccaattttttaacacaccctagaattatgtttttaa	gcattttttttttccaattttttaacacaccctagaattatgtttttaataaagtttaattgtaactagaaatcgtgtaatagtgagaaatggttctctcaaattccataattttcgagtgaatgctttaaattgtaaacactataggaagtatctgttctatcgatgtttaagttgaaaatatcaattaaaaagtacac	4TLS
aaaagtgagtagaaagcgagtgtttacagaatttgtttttacataatttgaaatttgcaggagtttcgcaaaaactcgagtgatggttctgccttcgaacccttctgctatggtgatctctcatttaagttgaaataaattgtttttataaaatttttttatatgtactcgagtctccataaattcattttcccaaagat	tttatatgtactcgagtctccataaattcattttcccaaagatgctatctcttcacacttgccgttggggtcaagaccaccctctctcactgtcaattctcctttcattcatgtttcttcggcgacttgtttcaaattttaagctctttctcaatttttcgtgtaacaatctatgtttcgtgtaacaatctatttttcgt	4TLS
tctcgaaaagtgaaattccgaaaccgccaactaccaacgacgaagatgaatttgtgagtggtccttagagtgtatttatagtttttttttcaagttttagactatttataaagccgtcgaagctgaaaatttggataagatcttcgttgatatattcgggatcacatgtgaaggcggggtgtggaaggcgtcagtgtatc	ggatcacatgtgaaggcggggtgtggaaggcgtcagtgtatccgaatgggattctgacgttcggaatcgattatgagaaaaattatgatggcatggatggtgcatatgatggtctgaaatctgaaattgataggatgtactgttaaattaaagtttcgaattggactcataataaaatttcctacattttttttccaaaa	4TLS
gcgatggaaatctccccaagtaagatttttcacaaagttacacacaaaatgttccaaccttttttcttttaggattctagtttccattgtggattacaatccaatgctgtttggaaaaaacagaatcgttctttcggttattttgatggatgatgaagcaaaagacagagtgaataaattgattggaccaataggagaac	aaagacagagtgaataaattgattggaccaataggagaacagtattccgtgcatcatatttcgaagaatattccatttctggtaccgtatagatcgtggctctcacatttggctgcaatcgttttggccacagagtatgtttatttcaaatatcatttcacttattaccttgaaattcttattttgaatctttaaaaaat	4TLS
ggcaaaagaacaccgaatcgctgagtcaaaaagagttctgatcaacagtagggaagatcgcactgtgtagaatgatctcaaatggcgccctgtttggtacggtgaaatatagggctgtacaaccggacgtccggtcgtccgaaccggacgcacatgcgtccggttgggggtagctatccacgacggccgacaatttccga	cggttgggggtagctatccacgacggccgacaatttccgagtttcgccactcactataaaactgctgattaagtatagtgagtggcgaaactcggaaattgtcggccgccgtggaaacctaccccaaaaccggacgcagtgcgtccggtggtgtcaaaatcggacgaccggacgccgatttgtacagccctagtgaaata	4TLS
aacaacacctaattcaaaccttttacgactatttcacattaatatgaaaactacacaacgtcaaaacaacaatacaacaaccacagcaaccaaaagtacactaaacatggatgttttccgacacacaatttacatagaatgaaatttgaaattgaaaattatttaaatttatttctgaaaatttattaaaaacaaaaacc	atttatttctgaaaatttattaaaaacaaaaaccaaccctttaaccatattgccttctgcatctgccaagttcaaaacatagacgctcatctgccgcctccagagtcacaaagtagtcaaaatttcgaatttttctgaatgtttcaaggtttttgtagttcaaacaagacgtcggagtaggagaaatgacacgtgagtaa	4TLS
atagagttggcttacttttcaaaaaagatgtaggaacattcgaaattgaaattctgaattttccaaaaaaaaaagtgcgaaaccacaatttgccaatttgccggtttgtcgatttgccagaaattttaaattccggcaatttgccgatttgccggaaaaaccgtttgccgcccacccctggatggacgaggtgtggtttc	cgcccacccctggatggacgaggtgtggtttctggtaaaatctttatttcaattcttgtcagcactttgtcccaaattgtgtcggctgctcacactagtcaagacgtaactttcttcacaactaaaatgcttgaaaccttgcttgttgtcgcttcattcacaaaatcttgctttctaataacagtccgataaactaaaaa	4TLS
tttttttttgaaatgaaactcactattcttggcaattatgaaaaatgtgacaacgttcagggaaagtaagatgaaaaggaattttacgaccagaaactggtggatgttgcaaggctctgggctgcccatctggacaattcgatattttcttaaattaatctccgagcgttcaaaaaagaattaaattactgtttgaaata	tcaaaaaagaattaaattactgtttgaaataatgtcagagtcatacgacttttggcaaaaccgtgcaaattttctataagagacatttttgttggactcatcaaattgacagaagagtacatgttttaacgaagtgcttataaatgaatttctttgtgaatgtccccgcccatgttttttgtcatatcggtaaacttttt	4TLS
tgaattgctcaaaggacgtcagaacccgaccattggtacaatttgtctttgttcattgaggttctttgaactcttacaatccgcaatgttcccggatagtgaaacacaaaaagggatacaagtggattacaaggaccgctgtttgcgaaaacaccgaaagagcaggaaatgacactgacctcaacgtttcgtctttcttc	tgacactgacctcaacgtttcgtctttcttcagctaccatctggccaagtaattcgttgcgtcgttgtcgccaactctttgagctggcctaaaagatggagaaactgtctgtattataattatgtgacctctaatgcatacctcgatgagcactggatcagcgatatgtattttttgctcaacttgttgattcggaaaag	4TLS
atctgaaaaaagtttcagagcatttcctactagaattgaatttatgaagtttttcgaaaccgaattttgcagaaatttttaaaaatctgcttcaaagcaatgaaaaaaaggacacaaataatttcacattaaactttatttgttcatagatctcatctgcctctaaatttttaaaggaatcttttataaaatcaaataaa	ttaaaggaatcttttataaaatcaaataaaaaattaaacaaaaacatatccaaaactataagaaaacaatttcgcataatatgtagcttcaacagacttgataagagaagctataatcaactctcttgtgaacacaaaagtgaggcgggaggaggtttggatttgtgagttttttttctaaaaaaataaaaaactaaatt	4TLS
gccaggaactccaaaagtcgtcaaagttgaccaacgtggaagagttatcctagatactactggtggaatgcagtaacttttatttgtttggtagtttttctgaattttcgtttcacttatcacttactttcttccgattcgttttttttgttacatcttctagtgtatgcattgtgtttttctgtctaaattttattcat	gtgtttttctgtctaaattttattcatgctaaatcttccctcaaaataaattactcaacaattaaaaggacatgtacagaaaaggaatcccctgaacagaatggatgagatgcttcttggcgctttctaactcgctgttgacagttaggctattgtctttcacgtcattcgtttgctcaaagctccacactaactgtttg	4TLS
atctaatctcattttctctcattctctattaaaacccacaaaataactgaaaaaaaatagaaacagaccaccatgactgtgatatagcgtggaatgcctctctctctctctcttctgaaaatcggaatatacaattttcatcaactttgattttgatctgctactggtatcgaaccaaatcatcaataagacaataatca	accaaatcatcaataagacaataatcaatcaattttgctaactgttcatgtttcataattagtaggcataacattcaatattttgtttttgacttattcttctttgctaataatgaagtaaaccttgatgtgaactaaaagttttaaaaaaacgtggtgatagatattttttgaacaaaattctttgagaaaaaacaatt	4TLS
aattgcaagaacaaaaagaaagaagaccatcggaagtctcattctcaatattatttcgcacattaaaccgtccgttctgatggttttatgatcattgttttggcatttggccgcccccctggtcttctgtgtctcgtttcaggcggaaaatattgaatgaaattggggatagttattcgaaattcatataatgttcactt	aattcatataatgttcactttctattattattgttatcccgtttctttttctgtgtgtacatatatgtttgtacattgtgtatcactttcactgtcaccttatcatatcatcattttaaagattgtttttttttgttgaatatttgggtcagaaattgatttcttttaatatatgtttcattataacaacctttaaaaaa	4TLS
acctcacgcctacctaaggcggacaggtttcaggcaggaatcaagtcttgaaaccgtgcctacctctcatgtctactgggataactcaccatataatgagataacgtgattactccaaacaattgaacattcacgtttctatcaaaatattcggccagaaattttttaaagatgcgaaaggcgacaaccattgtggcagg	cgacaaccattgtggcaggaatatacagaatcgggacgaatgccagcagaacggggactgtgaagaatgagaactggtagttgataaacttaggaactccatgaaaagtgcttggtacggagtagttcgtcaacgtcccagccattggaattttggaaatgaagtatgttttttgtttggctgaagctgttttctgacat	4TLS
ataatctgttggagttacgctcgccgagtgggcggagtagcgtatgggaaaactgcgccgttttcaagggtttcatggagttgcgagtccataggacaagttgcataactcgccctggggttttgtggaaaatggcatgcgttagccattccacgggatgcgtggtggtatttctagtggactttggggaagaccactac	accggtgttgtgcggaactccggatgcatctttccgtacttcatgcgggtgctggttcggattcccatgcatctgagaatcctagccctagctccttgtttatgcgataacagggatcagcgatgttatacggaaggatgaagagagcatgcgttgcggagcaatactatctcacgtcgtctttattgaatctcgtcaag	4TLS
ctatatgctatacactattaaaaactaaaataatcaacgaacaagtaattctaaattttttgaaatttgataaacaacttccaaaaaattgggtgatatctaatcaattctaatcgagagtctcattgtcaagctgagcagcaacatctgtagtcttgctctcttcagtcgtcccattttgctgttttccgagagaagac	caggaacaccaatgatcagtattccgttgatgatgtttaaggtatcaaatagagaggtaactgttggaggttgagcctataaaaatattgcgatttttttgctattgtgaaaatttaatattacctggaacaattcagtaatgtttgtactattgtcaagtttcaacattttcttttggaatgtaacagcttgttgagta	4TLS
gtcggctcatcagattcatcgaaatatgaaacatgctcagcacattcatgtatggctggaagctcggattaaaactaaatttttggggcctaaaaatctgaaaaaatcggttgaaaactgaatttttaggcctaaaaatctgaaaatgatcggcttaaaacttaattttaggcctaaaaatctgaaaaaaaaacgactta	gcctaaaaatctgaaaaaaaaataggcttaaaattgaattttaggcctaaaagcctgaaaaaataggcttaaaattgaattttaggcctaaaaatttgaaaaaaaatcggttgaaaactgaattttaggcctgaaagcctgaaaaaatgatcggcttaaaactgatttttaggcctaaaaatctgaaaacatcggcctaa	4TLS
actggcaattacagaaattgccgaattcgccaaaaatttccaaaaccggcaattgccgaatttgctggaaattttcaaaactggcaattacagaaattgccgaattcgccaaaaatttccaaaaccggcaattaccgaatttgctggaaattttggaaaccggcaattgcaaaaattgccgaattcgtcaaaaatttcca	aatgttttcaaaacaggcaattgcagaaattgccgaaaatatataaaaccggcaattgccgaaattgccaaaaatttccgatttctgagcaaccctgaattagagcttttttattcaaaagtttctgatttttttccaaaaattccaattttttctgaaaatctccaagcttcatcccgtaccaaggcggtctttccaac	4TLS
gacaattatgataacgtgaatttacgaaaaagtttaaaaaaggcgagaggtaggcgtcaggcagacaggttacaggcagacgtcatgccctgattccgaacccgagtgcaactagggctgcttaagggacttgtcccttcagtggggctgagccccatccctgcagtaaaatacccagtgggataggtagttgtttggca	ggtttcgcacaacactatacagagggccatggtggctagtggcttgaggccggcggaaccccgaaagtgtcggtggctgccaaacaactacttattgcactgcgtttttttgttcatgtttgcctaatctcagcccaaaaaaaatggttgagactcagcccctctcacccctaatgtaagtacaataagatcagctaatt	4TLS
agtcgataactcaaaaaattctaaaaaatttggataatctggagaaaaaacccaaaatttgctgaaaatttcgaaaaatttagctttaaatttttgcgcatggccgccggaaaagaaaaaaactcggccaccaattttttggcggccatgatgcaagacaccatatttgacgcgcaaaaaaaggtgtttttggatgtttt	taataaatttccagggacaaaaaatcataacctgttgcaaaaatgttttttttttcgaaaaattcaattttgcgcgtcaaatgtgatgctttaagctctgtggccgccgaaaaagagaaaactcggccaccaatttttcactctccattgacaatagcctgctggacaacgcgtggaaaagtgtcgtgtactccacacgg	4TLS
acttgagagttttgaaacaagttcatgaagcttatttgtagttttgatggttttcgcgaaaaagtttacagtatcgaattttcaaaaagctgataatcgttacaaaatcgttacaaaccattcaaattttctcctggtgagacccatctgaataaatccatgcgcctttaaatacgagttctaaaatgttcgataataat	cttcacattttctcttgctgaaactgaagtcaacataacttcctctgaagaatcacataatgaaactgaatcggaaattcacattccatcatccgaagagtctccaaaagaagaaattgatgataagctaccactagaagcagttctacaaaaatccaaagaattcgatgaaatcccaactactccggataatattccat	4TLS
tcgtatcatcttctgtgacgtcacagcttacagtggcaaggcgttttaggcggttggagaaatattgctttgaggatagtaaggtgatgtggtcggggtgctgtagtagtactgtagaggtattgtaggcgtacggtagtattactgtagctttggagaaagtaatttttttcttttgaagggatattggtcaggggttt	tgagccttctggaaaaatcgggaaaattctagagatttccagagttttgtggaattatatgaatttacacttcaaattatatgaaagctatttgaaacagtgaaaaatgtattctgtttttaacttttttttgaattcaaatttttcaaaattttaaaaactacacttcatatcttgtaatgttttgtgaatttctgttt	4TLS
atcttgaaaattttgaattttgcataaaattttcaaaattatcgtcatattgctcaaaaatacaagactagaagcccgaaacggcctgaatcggcctgaaattcgcctaaactattttttttgtaattagtttaatctaagaagataatcaatgaaagaaactttcaaattaatacgatgtttggaaaaaattaatccaa	acgcccaaaattgaattatccttgctgaactgtaaagttttcagaatttgacattcatctcaaatataatctgtgagcatctggtttcaggccaatttcaggccgggtcaggccgttttcgggccgatgtgggtttcaaaattttgcaaattttacgtagaattttatgttttaaacgtagaattttatgttttaaacct	4TLS
gaaaaaatattgcttacgcagtttttctcagctccatcacttcagaacctttcaaagctctacctggcatcctctgacgatgctcaagtgttaagccaaatcaccatcacatcaaatgggcaaaccaagacattggatcagcttcaagctaatgtcgatgcaaatggctttcaaaatggattcccggtcaatagtgacct	gtccagatatggcaaaagatcctaactttctggtatacgtggtggctgatcaggtgagaacagtagatcgctcgacgaatgatgagacgactctggtcttgttgaatgttcgcaataccagtcgagctccatattacaacactagagtggagagcatcaatcagccaagtgtgagttttgggggtactgaattcgagtag	4TLS
aaaatatgaaaagtattaccgtttcagaaaattttagttttttcacagcagtgactccaatgatgttacaaacacggccgattgtattgatgatcatcctatcggagcaaaaatttcgctaatttttgtttgttcgacacaaccactaccatatgtcttcgccttatcaaaggtcaaatgctgttaagagtcatcatttt	acgttctagcgcaaaaaccgtgactgggccagtggttttaaacattgaatttgtcaatttctttgcaatcaaagcttggtaaaacttcactaactccaaaatttctttcgagttgtgcttgtagtttatcgatttataagctttgattttttgtttaaaagttagtcttgacgtccgactgcaaataacgaacttcttat	4TLS
tgttgtgaaaaaatattgcttacgcagtttttctcagctccatcacttcagaacctttcaaagctctacctggcatcctctgacgatgctcaagtgttaagccaaatcaccatcacatcaaatgggcaaaccaagacattggatcagcttcaagctaatgtcgatgcaaatggctttcaaaatggattcccggtcaatag	gtccagatatggcaaaagatcctaactttctggtatacgtggtggctgatcaggtgagaacagtagatcgctcgacgaatgatgagacgactctggtcttgttgaatgttcgcaataccagtcgagctccatattacaacactagagtggagagcatcaatcagccaagtgtgagttttgggggtactgaattcgagtag	4TLS
attcggctctgaatgtccggggttcgactcccaaaggagtttttaaaaaatttcaaatttttgtaggtgtttaagaagttataaaaatgccggttttgttcagaaatatcaaaaaatcaattttgaaaaaagtgtccaaatggcccagtgcgaaaatccatgaatcccctgagggtctaaaggtgtggggttcaacccca	aaataaatccttaaattttttttcaatttttaaagaattttaacgtttaatttttttaatatttacaaaattttaaacaccaatttttaaaacaaaaatattttcagtcacaaaactttaaaaaatccaataaaaccgaggtcatcagacatgtcaattgtttatacaaacacggagagcacaggaagggagaagctcta	4TLS
cataggttggtttgccatttgctggcgttgtaaaataggatcaattcgaatattttgatccatatttccttgttcaaatgcttctattggaagattgaagctaaaaaccgctatgtcaaattacgaaacatttcgaaattacaaaactcactctacgtcgttttgaagaaattggatgatgttgaattgttcgacgttcg	gttatgcacgcgttggcaaattgaagggaacagtcgcggtttgacctggcaaaaagaagggtacaccgagcaattattgattttttggtcaaatacacatcgcaacacatgcgagagaactgtgagccatttggctcactcacatgactttttttatctctcatcttctcaaaggcacacacgttctactctctgcacac	4TLS
ttggtagagcaaaatagcggagtgtcgttgttcaaatgtcgttggccactaaaattgaaaacacgaccacaaatattttctaggccatcaatttttctaggccactttgaaatttccaaaacaaaatcggagctgaatatgacgtcagtttttttaaaacttgtttgtaaaatctcaaggagttaaatttttcttatcgg	gaaaaagagatatatgtaaaatggggatggaatcgggaagattataaaaagtattataaaatggggggggggggggagattagagtgaattgatgaaaatgcacgggaaatgacatggtgattttgttggataagaaatacggcacgtagaagagttttgaaaattctagtcacattttcgtaatttttttgcaaatttt	4TLS
ttgtgattttattgatttttttttgttgaagaaaattaaaaatcaataagttatcgattttttttgtaagatatttttgtccaatttatgacattttagtgcaataaatagtgcaagctctcttcattgttagctttttttcaatttttatcaattttagaaaaaagttgggtctcgccacgaaatcctacagtaacctg	agaattcgctttgagaccaattttcaaaaatgtataattaagatttgaattcagctcacctagagctttcatttaagtataatcatgacctactttgctccaattagaaaaaagttgggtctcgccacgaaatcctacagtaacccgttagatatcgtggcgagacccgaaatttttttacagaatcaaagtaggtcatg	4TLS
tcatttgaatattttgcaactgccggaaacatgaatataatttctggccttaaataaaaaactttgatagtattcgggaaaataaaataaaaatggaatttttaacgaccctcttattgctagctacagtaaaaaataaatggagattcttaaattgaggaaatttatatttacaccaacaaaaaatagtgattaaattt	gttaaagcaattcgtactttattcaaaaagtgtccatgaaaagagaccagtcatagtctaacattgtgaactttcgatgatctgaaaatttcgggagatgatgaaacaaaatttgagccggttaccgcccaccaactcccacattaaaaccattttgttatatttttctcctttttctttttatatttatttcaatatat	4TLS
ttactgaaaaatttgataatttttccattttttcaatgagagcgcaatctaagaatcaagtgaattcacaaaacttggtgcttcgatattatcttgtatttcgactatttcgagtattttcgagttcgagtatttcgacgcagccgactcttttcgggtttcgagccaaactatacaaaaggagcggcaggcgttttcga	ttggttaaaggtggtgtagtcgaaatttttattattaccttattagacatgaatttgcttcataatgatgtttcttaaaaactttaaaatatttcaaaaatattttttgcgatacatatttttgacaatatgattttccataaaataactaaaacattattttgcaaaaatgtttagtgtcaaaaattctaaatttttgc	4TLS
ttttattcaacgccaattgtttcctcctcttgcagaaaaacgtcaataaattccacgtggcttttcggtatggttgataaataaataccaagacaattgtagaaagtactccatgagacgagcctattataacacataaattggtcaaattctggtttctatagtcaaaaatagtagatatcatctctccgaaaacaggt	acttacttgaagtacaactgctttcactaatttcttttgtagagattgggttcgtattgataatgtagatgtttgggttgtactcatcaatttcttgacgaccaaaatcaggaaagtgaaaccttcaattgcaaccagtaaagattcaaacataatacaaacaaatggaattttgaagtcaagacctgccacgaaaagtc	4TLS
ttcattactggccttttccgaatccacagattttgcataggaaaactattcaggtatgtagagtatttttagtcttatgcctagaccaattagcgctggcctaaccccacttttgaaccaattaacgacggcccactgcaactaatttgattcgtcgggaagactgtgctcggaggaagttcaataaattatagatcaaa	cgactcgcagtgacgatatgctgttcacatgagtgcacgagaggacataatcacgtaccgatgagattatgtatggactgtagtacattagtacatgaagaagggactattaaacatttacaacatcaaggaagtggggttgtatggtcaacagatgatcaatggccaacggttgaaagtattgtaaagttattaaggga	4TLS
aaattgaacgacgagaattcaacgcagctgatatggaagaaagaatgcggtttcgagagcatgaataaataactcttgaaaatattcaaaacttgttctggaaaacaattttatattaacatgctcgttgctttccaaatcttggataaactgcacttttggtggtttttatacaattagtttgtatttgagttcaaact	tttacggaacattcatagctccaacttttcttcgttttctacagaataactttcgaatgccaacatcaaagatcaacaagatataaggaagtgatagggtgatctgaagtgtatcgtttttagatgtcaattacatgctactaaccaaatcagacgagattcctaaagacatgttaaagatatatccaaatgatggagga	4TLS
agttctcaacgcggcgaaaagctgcgaagccgcgttccgttcactccaatcagctcgacaagcttcaatcgcaactcggagagcccgttcgaaacagaacactgctttattgtgaagagtggagctttgaacaattgtcttcataacattcatcgaatgaactctgtactctgacgtttttccatccatattcaacagcg	cgaattggcaaattgctggaattgaaaatttccggcaaatcggcaaattgttaaattgccggaattgaaaatttccggcaaactggcaaattggtcggaaactttttttttcaatttttccatttttctaacaattttttacaaaataaaaagataaaacttccaaaaaaatgataattttcaaaattttttcgtaaatt	4TLS
gcatccggcctctgcaaagggaaagacagttcctggagcacgtcggaagaggcgatctaatctcggagtccaaaccatctgtcaatcggacttggaaattaagaagccgcgggacaaaacaagaagaactgactatcgcgtgtgcaccttcaactgcaggtccttgtcttcggatgatcgacttgctgagctgctagaag	attgcttatgcaatctcagcgacagtcacggttcagagtgatcctgatttagatatcgactatgataatctgattcagtcactaaaagaactccaagaccaagctatcgttcgaccggccaaccactcatccaacagactttcggaggaaacccgaaaactgctgaacaaaagacgttttatggatagaaatgatcctca	4TLS
taatcctggagttcggatacgtttgacgaaaaaaggagcgaatcatataaaaacggtcggaattcaaatattcaacgattatatttcccaactgaaggtataagattcaccatttgagtaaaaagtttggcattaaaaaaaaagaacaatatcccacatccgaattttttccattttcattgacactttcaatgcctata	aaaaacacaggttttatatctcactcacgtcttttattgagaccaaaagtgtggagattgactccaaaagacactaaaacacagtgtaaaacacaatatgagacaccaaagtctccaaaaaacctaaaaccttaaacaaaaacaacaaaatagtgtcgagcctcacggcacgacctcttcttaactcgttctccgagcga	4TLS
gaaatttttttcggccgtttttcgaccgttaatacaaaatttgaaatttttccagaagcgttgttctatgatagctgacgattttagcatataagctggttttattaatgtttaagaagaacaagagacaacaaattttgtatatcgaaacgtcaatatgatgttaaaatacaaaaaattgactgtgaaaatcaatttaa	ttaccctctgaagtccatgacttatcgattaaacactcttccgatgagcacatttcctcatcaaaagggaatccatcataaatcgaaaagtttgtagatccgggactgggatagtcatagctctggtcgtattcgtaaattgagctgacttctatcaaaaaacaaaatataagaatccacgaaaaccatttcagtttccc	4TLS
gaaggtgtctaatatggacataagctgctctcggccgctttatgacgcacttcgtagtggacacgaagatttgattataatcctcaatcgttgtcgtcctccaaccaacaacctacagctccgcccactctgcccaaagaaccatggaggaggacgatgatttttgacaacaacgacgacgcaaccttttgcgtggataa	gaacctctgtcatccctgtcaacaatcctcgattgtcttgaacattgcggtagcggtgtggttccctgaaatttggatggtattatcaattattcaattgcgaagttcaagttctaaactatgaaacaatattgaattacccgtggagtgacttcctctaaagtagccttcttgtccttcttcaattttgcacaaaaaac	4TLS
acgagtgagttttaatcaattgttagcagtcgtcatcattttctcgaaaattcaaactattgcgaaatatcaaaaaacgacaaacttatgattttttcagggctaataactacgacgcctcgtcctgtttctataaatgaaattcgaatagaagaggaaaccatggaaacaacaacaaatgtgataaatctagcggtaaa	atcagcagtttgaccaatcgttctcacaaagcctgactcaacaggcccaagaagatggattcatgacacccccggattacagcgatggacctctcacaatggcatcatcaccccccacactgccacctgtgcaatctgttccagtatcgtctaagcctgcgcctccatcggctgaaaatcaggctcagaattctacgtct	4TLS
tatttagcagacccacgccaacttctgatgggtctgctagactacaaactacaaaagcctatttagcagacccacgccaacttctgatgggtctgctaggctacaaactacaaaaaatatttagcagacccaactaatgtcttataaatttgggcctgctagactacaaactacaaaagcctatttagcagacccacgcc	gacccaaccaattttttataatttgggtctgctagactacaaactacaaaacgatatttagcagacccaatcaatttttgataaatttgggtctgctagactacaaactacaaaaaaatcttgcagaccaaagactacagactacaaaattaacctgggctccaattccaaaattgaataaaatagcggaacaaataata	4TLS
