gtaaattgtcgtaaaatattgttttttttttcaaattttaattgttttcaaatggtcgatttaaaaaacgctgaaaattaactttttcaagaaaaatcgatttttttttcattttattttctctcactttcaaaaaatttctgtgttaaatttcagattttccggtttcgatttttgttccggaaaaaatcgattttttt	taaattgtcgtaaaatattgttttttttttcaaattttaattgttttcaaatggtcgatttaaaaaacgctgaaaattaactttttcaagaaaaatcgatttttttttcattttattttctctcactttcaaaaaatttctgtgttaaatttcagattttccggtttcgatttttgttccggaaaaaatcgatttttttt	eta
atcttgtttacgtaaattaatacatagaaaattcgagacccccaaaaatttgtgctatacttcaaatttaaagcagctaggatttcagaccgtcaatggatttttttttgataccacagcaagtactacactttacgtttcaataatttttttaacatttactattccttcctcaaatgaatttgcttagtatttcaaat	tcttgtttacgtaaattaatacatagaaaattcgagacccccaaaaatttgtgctatacttcaaatttaaagcagctaggatttcagaccgtcaatggatttttttttgataccacagcaagtactacactttacgtttcaataatttttttaacatttactattccttcctcaaatgaatttgcttagtatttcaaatt	eta
ataccactcatccatttttcaactgctactgcatttgctggtgctgctcatttataaaaaatgatgctccatacccgagaaagagtgtcaatctaatgtgtttttttttctgttggggaccatctttccaacccattgtgcttccatattttcacttttgtttcacactttccacccgacggatccttttgttcccgttt	taccactcatccatttttcaactgctactgcatttgctggtgctgctcatttataaaaaatgatgctccatacccgagaaagagtgtcaatctaatgtgtttttttttctgttggggaccatctttccaacccattgtgcttccatattttcacttttgtttcacactttccacccgacggatccttttgttcccgtttg	eta
ttttgttttttttttcatcccaaaaattaagaaattagatttcttttttttcctcgttttttcatgtttttttttcttttacattttatttcatgtttcatttttttttaatccgtttttaacaattttaactttttttttaaataaaaaaaaccatttttttttcatgttatttttttccgtttttttttcgttttaac	tttgttttttttttcatcccaaaaattaagaaattagatttcttttttttcctcgttttttcatgtttttttttcttttacattttatttcatgtttcatttttttttaatccgtttttaacaattttaactttttttttaaataaaaaaaaccatttttttttcatgttatttttttccgtttttttttcgttttaaca	eta
ctgttttataagatttgagttcattattcacaaagttttccaacgcttgaatttggtgatgctcaacaaactttgataaatcggtgatagagaataactgaaaaaaaaattacttttcgcattatgtgggacaatatttaagtaatttgccaaagcccccgttttttttttaaatttcaatttgccgcatacctcttatg	tgttttataagatttgagttcattattcacaaagttttccaacgcttgaatttggtgatgctcaacaaactttgataaatcggtgatagagaataactgaaaaaaaaattacttttcgcattatgtgggacaatatttaagtaatttgccaaagcccccgttttttttttaaatttcaatttgccgcatacctcttatgt	eta
gtggttgtttacacttggagaactgtatttgatagttttattttcacaaaaaatgtgtcaaagcgcataaactatatgcagcaaatatcttttaaaaattaaaaaaaaaactaaatattaaacaaaaaagttaacatttttattcactgtcaaaaaatggcaaccactcaattttcgactatcaaaaaaaagaatcgaaa	tggttgtttacacttggagaactgtatttgatagttttattttcacaaaaaatgtgtcaaagcgcataaactatatgcagcaaatatcttttaaaaattaaaaaaaaaactaaatattaaacaaaaaagttaacatttttattcactgtcaaaaaatggcaaccactcaattttcgactatcaaaaaaaagaatcgaaaa	eta
aaataatagggaaaaatagcgaaaaatatttaaatgacaaaaaaatacagaaaaaaaacagaaaaacagggataattagagattcttcgacttttcgtacaaaaaaaaactggggggaaaagaggcgcagagatcacatatttgagggtagacgggcgggaaagagagaatatattacattttgacaagaattttttgtc	aataatagggaaaaatagcgaaaaatatttaaatgacaaaaaaatacagaaaaaaaacagaaaaacagggataattagagattcttcgacttttcgtacaaaaaaaaactggggggaaaagaggcgcagagatcacatatttgagggtagacgggcgggaaagagagaatatattacattttgacaagaattttttgtca	eta
ctcttcttattagaaaagaaagaggtgagagatggagttttagagaaaaagtgtttataagagatatataggtgtcatatgattagtttttgacatattactcggctttttttctcggcggaaaatttttggactttattctgttttattggcttaaaaactagaaattcgcagttaaaatgtttgaaaataatatttat	aaaagaaagaggtgagagatggagttttagagaaaaagtgtttataagagatatataggtgtcatatgattagtttttgacatattactcggctttttttctcggcggaaaatttttggactttattctgttttattggcttaaaaactagaaattcgcagttaaaatgtttgaaaataatatttatacagctgccaggc	eta
aaatttgaatttcgaggggtacggtagcctcaaaagtacgcaaacaccgaggggcttgcgtacttggcaccgaattttacgacagttagtccaaattgactgaaaaccggattacgggggtaaaaagtgatggggaactcgaatttcgtattgaaaatctctgaaaatcactgaaaattgctgaaaatcgcaagtttttg	gggcttgcgtacttggcaccgaattttacgacagttagtccaaattgactgaaaaccggattacgggggtaaaaagtgatggggaactcgaatttcgtattgaaaatctctgaaaatcactgaaaattgctgaaaatcgcaagtttttggaaaaattgaaaatttgggcatagcttccgcatgtccgagtgacaaatgtg	eta
agtaaaaatttcaatttttaactaattttaggccattttttgagccgtcataactatttttttgagaagttttcaagaagtttcattatgaaatttggtgttttcagacaattttgagtctgaaaaagcaataaaaaattcgactacaccacttttaaaaaattgccaaaaatcgaaaaactcaaaatcaatattcaaaa	ctatttttttgagaagttttcaagaagtttcattatgaaatttggtgttttcagacaattttgagtctgaaaaagcaataaaaaattcgactacaccacttttaaaaaattgccaaaaatcgaaaaactcaaaatcaatattcaaaaaaaaagaaacaaatatacaatcttgtagtgctcaacattacatacatccacac	eta
tttttccaattttcagaaaaatcggaaatttccgtttttcgtttttcagaaaaaaagcagttacaatagaccaattttcagctaaaatttcacatttaccctaattttcaattagttttttttttatttttcgaattattgtattttattacgcgttttattttaattggggagttttctaaaaatgcgaattaaactac	tttcagctaaaatttcacatttaccctaattttcaattagttttttttttatttttcgaattattgtattttattacgcgttttattttaattggggagttttctaaaaatgcgaattaaactacaataattcaaaaaaaaaaaccaatttcaggcggctacgtcactgaaaagtagacaaaatttgagatttaaacaga	eta
tatattcaattatacaccaaacaataaaactggctaattttaaaatgtagtatttttaactaatggaaaaaggtggagattactttttcaaaaatatgaaaattttatataatgtcactgaaacagtaatttttgtaatttcgaatcttttacttttcaacttaaaaataaattcaaaattaattaaattataacctaaa	actttttcaaaaatatgaaaattttatataatgtcactgaaacagtaatttttgtaatttcgaatcttttacttttcaacttaaaaataaattcaaaattaattaaattataacctaaaaggaggaaaataaatatttgcattcccttgttccagtttgatatccgtattctgcgctaccttctctaaaatctggtgaat	eta
cagaaaattttaattctagattctgagaattggaaattttgttataatctacaattcggttactaaacggcattctatccctggaacctactcaattttgcagttctacagtactcacctcctcaagtcatccagcctggctctctctgcttcgatatattggtcgatgattgttgttacatccttctctgctcccagca	tggaacctactcaattttgcagttctacagtactcacctcctcaagtcatccagcctggctctctctgcttcgatatattggtcgatgattgttgttacatccttctctgctcccagcatatgctgaaatctctaacttaattacataatcatagattaactactcacctgcaaatcagcaattgcagtgaacaaatctg	eta
aagttagttaaaatcggaaacttgacttgtcagcggctggacacagtttttttttgaaatcaccgtaaaatttgaagtgtacaagttgattatctcgcgttttaaacttcattaaggtattttaaagtcgatggacggcgagttttggctcaaataaattgaaaatccatcgccgtccatcgatttttaaataccttaac	ttgattatctcgcgttttaaacttcattaaggtattttaaagtcgatggacggcgagttttggctcaaataaattgaaaatccatcgccgtccatcgatttttaaataccttaaccaagtttaaaacgcaaggtaatcaacttgtatacttcaaattttacggcgatttcaaaaaagtaagtttccagacaatttccgat	eta
aagttgggagcgtagatcattcaggatatgcagaaattatataatattttatctgttcaaaaacctgataacttcaacttaaaaatgaattcatttcataaaactttattgaaaagttaaagtgaaccagcttggaatgttaaagtttaaattttctttttgggtagtcagtcgatagtaatctgaaaaatatttgtata	tgaattcatttcataaaactttattgaaaagttaaagtgaaccagcttggaatgttaaagtttaaattttctttttgggtagtcagtcgatagtaatctgaaaaatatttgtatacttccattcaaaatatatttatgtatatagttccctggaaacttccaatagtgacaacataaaactagtagaattggtacaatcc	eta
gaaatcagaaattcggaagtgtgagccttctgtggagtgatgttgacatcttttctgaatatgaaatattcggctcactccaatttatttagtttagtctcaaactaaaactatttttttttgtttttgttgattttgtgtctatccttgtttttctcacttacccctagatcagagacctcagctcagttttttctaga	ttagtttagtctcaaactaaaactatttttttttgtttttgttgattttgtgtctatccttgtttttctcacttacccctagatcagagacctcagctcagttttttctagaaaatagtgttattgttattatcaaatttatcaaatgagaactttttcatcagctcaagaacttcatattacgctcaacctacaaaaat	eta
cacactttcaggattgcctccaaacgatgcaatgttatcttgaacccattgaagtgctagagtttgatcccataatccataatttccatttgcaatgccatcagcaattgttagaaatccaagtggtccaagacgatagttcattgtaacgacgattacatctttcagtggaagagttccggttaacgagtaatcgtcca	tgcaatgccatcagcaattgttagaaatccaagtggtccaagacgatagttcattgtaacgacgattacatctttcagtggaagagttccggttaacgagtaatcgtccatataagaagtgaatccaatttcatagccacctccataaatatacaccaatactggaagaccctttggctgaaaatattctaagttgtacc	eta
agaagcatttcaattaatttgcgtgagacggagtttcccatcacttcctgtaatggtaaaaagttaggactgacacgcaacatttcaaatgtttcacttacaatcttgggacttggtgtgccctccgaatcagaattgttttctgagttggctccactcctctttctgcgctttgtgctaccaatacgatcccgctcgtt	gtttcacttacaatcttgggacttggtgtgccctccgaatcagaattgttttctgagttggctccactcctctttctgcgctttgtgctaccaatacgatcccgctcgttttgaattgcttcgggcttcattccatcggcgaggcacttttgaaaacgacagtatctgcatgcattcctatgatctttgtcaatgttgca	eta
aagcatgaaaattgagttttcagtatttttcggcgctaattaaaaacgttcaaaattttttaaaggtgttcaggtaggctcaattttctgcaagaatttctgaagaaaatttcgaaattttcgtaaaaagtcaataaaccctgactcaacttgttgctaatcattacttctgaaatgtcatagttttgcaaatactggca	agaatttctgaagaaaatttcgaaattttcgtaaaaagtcaataaaccctgactcaacttgttgctaatcattacttctgaaatgtcatagttttgcaaatactggcatatttagttaatgttctccacggggcgctaggcttagacttagtattagtcttaggcctaggattttaggcttaggcttaggcttaggttta	eta
gaattcctatcgaaacctattatattaaacatcttccaggaaaccaatggcatggccagacaacaacacctcaaactgccgggaaacctactcctattttggctcggcagactatctgcgcaatgcatatcatttcacagcacttttaacagttcctctatccatattcacattttacacagttataacaaagacgccaa	tattttggctcggcagactatctgcgcaatgcatatcatttcacagcacttttaacagttcctctatccatattcacattttacacagttataacaaagacgccaaagcggatgaaaaatatgaaaatcccacttttaatatccctggcttggagcacaaatctcgatttgatgttcacagtgtactcggggccgtatat	eta
tgcatttgggttcactaaagggcaaataagcacgaaaacttggtttttagaatgataaaatctaggaatttcgaattacactacatttgtaggttctcgatagaccccgaacacgttgtgtgcctcatttcagaaaaccttagtcttaaaacaattcccagaacctagaattctgaaaaaacgaccaggaaacagctaaa	tcgatagaccccgaacacgttgtgtgcctcatttcagaaaaccttagtcttaaaacaattcccagaacctagaattctgaaaaaacgaccaggaaacagctaaaaacatggaatgaatgaaatgggaggaaagacgaagaagggcgccaccaaaatgggcggagcctaaaaaggggctcctgaaaagatgaagagagaga	eta
tttcctcgatttttcgagaacttcgtactcttcatcatcgtcagactcttcacttggcacgaattctgaggaatcacttcgtcgtgactttttcctggattttgagctaattggctcagccaacacatccgcgtcattttcacagaaatcttcctcatcaagttctggctcccatttttcatcaaaatccgacgagctcg	ggattttgagctaattggctcagccaacacatccgcgtcattttcacagaaatcttcctcatcaagttctggctcccatttttcatcaaaatccgacgagctcgaatttgatcttctgaaaattcatatttaattgaaatgttatgaaatgtttaatgatacctgagagctgcctctctatacttcggagtattctgatc	eta
ttgatctactatctacttttcggcgccaaatttccaattttgggtgcagagactctgtttctttgagttttccgttcgatttccgctcattccgtctcctattcctgttctctgtggacaaaaatgtacagtttcaaaagcagcaccgacgtgaagacttatatcagcaccccgtcgtgccggatatgtcttgagccatt	cctattcctgttctctgtggacaaaaatgtacagtttcaaaagcagcaccgacgtgaagacttatatcagcaccccgtcgtgccggatatgtcttgagccatttggttagtgagtttttgttggcttaacggcttttttcgtcagtgtttggctattttcttgcaaatttttaggtgttttatcgattttcacattttta	eta
ttcgcgcctcgctcagtcggaagccctatatcaaatattttcagattctctacttcctatgcttccttgcaattttaaaactcaatcttcgagttccggtctaccagctgatgctttttctatcaattgtcgatatgttgcaactaagctgtaactcaatagcaacgggtctattccacataattggaatatcgttttgc	accagctgatgctttttctatcaattgtcgatatgttgcaactaagctgtaactcaatagcaacgggtctattccacataattggaatatcgttttgcaaatttccgttcccaatattcatttatggagctgtcgcccaagcatcatggatgagtgggagcgtgtgctcgatttttctagccgttgaaagatgcgtggag	eta
tacacgagctgcgtaaatcgaaacatagctgtctggcctaaaataagtggtattttgtagccagtgcgaagttccaaaaaaccatatccaaagcgggctaaataattaaaaacgcatgttaattttctgaaaattaaaaaatttcagtcaatggctccacttggctacatagatgacctataccgtgtccattctctaca	aattaaaaacgcatgttaattttctgaaaattaaaaaatttcagtcaatggctccacttggctacatagatgacctataccgtgtccattctctacaagtaatcgatttatctgccaatcaaattctctcatttccaattcaattaacacttttatcacatctccgacaacttaatctatcatctaactacatatcatca	eta
gcccagcggtctttgatggcactttttttcggaattaagtgtgcaaaacatcatgtttgatgagtggaaaatttgaattttgaaagtttgaaaatctgggagaaaattaatttttttaaaaattttagttgaaatttttttcaattttttttcttagaagaaagttttttcttctttttttctccccccccagatttcgt	taatttttttaaaaattttagttgaaatttttttcaattttttttcttagaagaaagttttttcttctttttttctccccccccagatttcgtgacgggacccgagtttttcaaattcgagggaacctagtcatgattatactcaaattgaagctctgaatacgcttaaaacgaatttgaaaataaaaactgaccaaatt	eta
cgaaattcgatggttcattcatatcaatccaaattccatcaaatgcaacttgtgattgatagttcacaaattcattgatccaccagttctgagtgttatttgtggaatccagaaagtcagggaatgccacgtgattatctggccaaacaactcccaacatgatcttagtgtccttagccattggatataaattttgaata	cagaaagtcagggaatgccacgtgattatctggccaaacaactcccaacatgatcttagtgtccttagccattggatataaattttgaatagcagtttgaacttgagctttggtttcccattcaatgaactttgcatttgcagcgattgctcgttggaaagatggataagtggcttcaatggctggatcgaaaatcaaaa	eta
acagcaaaaaaccgcatcaaaatccatccacccaccgtcaagttacacgcgcgttttcaaagtgaacaaaaaacagggcataaaaaaatttagacgcccgcacccggactcgaactttttttatattttgaagcttaatatctcggctcctgtacatcgaaattggctcaaaattcacaagaaaccttatcctgctacga	gaactttttttatattttgaagcttaatatctcggctcctgtacatcgaaattggctcaaaattcacaagaaaccttatcctgctacgatcctcctgtcattaaattttcgtgagcttagaccgaaaactgacaaaacgccaaactttcaaattttaaaaaatagttgagggtcattttgaaaacaccttaagctccata	eta
acgtacatagtcgctaataaaaaacattgttctatcatttgaatttggccaagacttgcagactttctttaaaacaaaaaaaccaatttcttaaaagcagcccatttttaccaccaaatgaaatgaaaacacttaattgtaaggggagtgatgttcgcgagatttttattctgaaaaattgaacaagactttgaaagagc	aaacacttaattgtaaggggagtgatgttcgcgagatttttattctgaaaaattgaacaagactttgaaagagctactttcagacttagactgactttttttgaatttccgcaaaaaagtatttcatgaaaatttcaggaatgtaacgatgatgaaagaaattgcgccgccaaaggagataaattcatttattcaactaa	eta
agattcttccgatagttcaatgtggtacatttgtcagtcttaatttatataatttaactatagcgagaccaagtggaatgtcgaaaaagactattcaaatgcaacatttattgatttttgcgttgattcttcaggtaaaaacttttttcttcgggacgtaaaccagttttaagtagaaaatttgaattctacgtgaattt	cttcaggtaaaaacttttttcttcgggacgtaaaccagttttaagtagaaaatttgaattctacgtgaattttgcgttgatttgacacccatattgactagattccaagtttgttaagtttcaggcctgaaatggcctaaaattggcctgaaaaagcttggaactccaacattgctgaatatgaggcttacgttagtttg	eta
aaaaggtttacgagaatttgtgttctataaacaatacgagcattcggagagaaatatgacactttttcgaaatatgctaggaaattatatttcaatatatttaaaagtcctctataataataattattattgatttaatttaattgtactctattatcaaaatatataaactgacatgtgaaacgtggcttattttttat	gatttaatttaattgtactctattatcaaaatatataaactgacatgtgaaacgtggcttattttttatttttcctttcgttgaaattttaatttattagttcattttaaaaaaatgggaggagctcaaataaaaaacaaagcaaaaaaaataagccacgtttcacatgtcagtttatatatttttgataataacgaaga	eta
ttgaaatgaataaaagcaattaggtatttttatttcaggtttactttgaagttttcattgaatattttctaaatccaaatttttcgctctttcgagcttcaggcacgccaaaatttatcgacatagtttccactccaataattattcaattgtcgtatatatttagcaacaaacggaatgtgaatactctctgctcttcc	ccaataattattcaattgtcgtatatatttagcaacaaacggaatgtgaatactctctgctcttccttcaagtttatcaagttgatgaaatatgtgtacaacgggagaacaaattcagtggctccaaatcagccagtttattcaattacagaaccgccacagaatttaaacaatcgataattgttctttttgactttttc	eta
agacctaaaacaaggaagatgttaagaaatgcatgagacaagatattaaaagatcatcaaattcaagacggcgaagatgatatttgagcaataaataaccatccagaaaaaaattcgtaaaatgtaaaactcacgaaatagcatagtttgacgaccaataagtcaatgaaaactcattagatactggctcctgagatgtt	aaatagcatagtttgacgaccaataagtcaatgaaaactcattagatactggctcctgagatgttggagtggctgccgaaactgattcaaagtctgacgaagaagatgatttaatttcaattgataatggactatcgtcttgttctccgtcatcttcgtcagcaacaaaagacttttcaaaatcattatcctcatcgtca	eta
tcgaaatttgaaaaaaaaattttgggtctcgacacgaaaatctctaaaaatttgtctaaaccctctaattttgaattttttgatttttttacatattttacctagattcagctcgtcaagagcttcaaaataagtataatcatgactaggctttgatagttttgaaaatgtttgggtcccgccacgaaattccccggggt	ctaggctttgatagttttgaaaatgtttgggtcccgccacgaaattccccggggtactgtaggctttcgtggtgggactcaaattgaagctctcagtgagctgattttaaatatatctgtaacagtatgaaaatttccctaaaaattcccaatttttctttcagatgtacgaagtttcgttcccaacaccccgccgccca	eta
gttgtctctagacttcatgagagatagtcaaaatttggctaaattccagcttttcatttttccgcccacttgtcctgtttaccccaatttgtaatgttttactattcagacgtattccgatacttgtagtcttcctgtaattttgcaaaatattgctattcctttttgctctgaatacttattgccagacatgttaaaca	cctttttgctctgaatacttattgccagacatgttaaacatttttttgaagaccactactatgaccactcttttggacactttcatgaaaatcttggaaaatcaaatttcccaaatttgacataatcgagtttgccgtttttttgcatctttactttttgatttccttataaaccgacttcggcgttttttgtcgagaaa	eta
gtcctgcagtcaacagtgccaatctaacaccaacactcaatgccagccaacgtgtcagcaatcctgccagacatcgtcttgcaatccgatgacttccacaccaattccagcgtcgcaaagttgtcttccagagtgtgagaaccgatgcatgcagcagtgtactcaacagcagaccgcgcaacagtgccagccaatttgtc	actcaacagcagaccgcgcaacagtgccagccaatttgtcagcagcagtgccagcaggaatgtgggtccacaggaaatatgatgtacaataatcaggatccgtataatcaaatgcagtatggagggtacaatcagcaaggaaatcagtaccagaaccaaaatcagtaccaaaatccaaaccagatccaaaatcagtacaa	eta
aacatccgcataacgattgagatccggattcgcttcataggcggtgtaggtacagtttggtggcatgtaccctttgatcttatcctgatgaagtttactgatcgcctggcatttctgaaaaaagggagtattatacaatcaataattcaaatattccttaccattttagcagctttaaaagcccaaatcttccttggatc	tttaaaagcccaaatcttccttggatcacttccaggctccggtggttgttcgttgtcttcatcgtctgattctgtcttactgatcttcttctccttgttcactttcttactcttctccttcttttcttctttcagcttcttcttactcagcttcttacttccatcctttttgtcaactttcttcttgtcatcttccttac	eta
tcaatcaatacactcatgtgaaattttgggcgtttttatcccaatttctaggaggttttcagaggaatttccactttttttaaataggttttcctattttttttaaggcttttccgtacgaaaagctcccagagttcaagcttgccacgtggcaatcaatatcgcctcgcattcctccctatcacagacacactgttaat	tccctatcacagacacactgttaatcagtgaactggtattttcttttcttttttttggtgtcatggtcatttggcatttatatcagaaggcgagggtttctctcgtgattttttacttcacttttccacctttttttttcgattcgtggcgagacccatttatcgattttattgatcgatgatgggcttcagggttaatc	eta
acggaaaatttcggaattttaagagtttttaggtggaaaatatgggtttttaatgcaaaaactgataaaaatgcattcaaatccgaaattttaagtgcaaaatcggtctcaaacggacaattttcgactctggataaagaatggcaaaaattttagattaaaaaaggaaaattttgacttttctgcggttttggatggag	ttctgcggttttggatggagagtttttgagtcaaaattggcttaaaatagttgcaattttgaaatttttcctatgtttgcaccaatactcagaaaattacaatttaagtgttagttgacacaggaattccaatttttttaaactctggggcacgtgaaaatttttaaaaaactagttaaaaaaaaaaaaaaaaagttaat	eta
gaatgtaccggctcacagaagatacgataaattgtttcgtaatgaagattccagaaaaagttattcatgtgaaaatcgaaactcatttaaaatctcacttcaaaaaatcggccgaaatgaatttcctattggatgccaacgactgttcggaattttgcagcgatgaataaattacatgttattcatttttgtttgttata	atcccaatacttcagtttaatcattaggattttttcatgtattctactgtgaaaatttattatggactacaaaatgataaatatatggatttaataggcaacgcaggcggttgggatcttgacagactcaacgaaggagactgggaaatcgaccaaatcggcaacagtttgctcacgagcctccttcaagaaacggcggg	eta
atagaaaattggtaattaaaatgtatgatcctaaatctacaaaaagtataaaatgtagatttccggcaaccggcaattccgggaattgccggttttccaattttccgacaatcggaaaatttggcaaaaaaatcaattgtcgaaaaaaaaaattgattgccgctcatccctgcttccttgtatccatcgctataatttca	gaaaatcgtggagttttgttgaacgaggaaaagaaaagttacgaggaaagattggaagcagaggcaaaagcacgaaaagaagaacatgatagagctgatgtatgtagtcttttcatcttcccacaaaatgttatgaatatcacatttttcaccaacagtgttggccaaaaatatatcccattttcgatttttgataaatt	eta
aatcttggaaaatgcgtcttgaacaaatatgattttatgtaactggattgggaaatggatggaagattttaataattccatttctatttaaatatttccgtatttaaacttcaaggtttggcgataataaaaaatttgtggtgtcataaaatgcaaaaaccagatatttatatatcgattgcgtttgttttatatttaca	ttgacaaatcaccgatgaaatggtatttatcatgctctgtgtggcagagcacaattgcagccgtttgcgtagctctatcgctgttgttcactgcttttgatcaagatttggagaacgagcccatgaataagtgttcaattcttcttgcagtatcccagtcgtacttgacgttttccttattaacattgctgattctgctc	eta
cgaattgagagcgacatatttttctgaaatttacataaattattcatcaacaagtagcttttcatattttcaagacatctacataattgtttcgaaaacaaaatcccaaaaaaaagtacacctttcaaaaaatgtgacggggccttttctttgtcttacaatgtgttttgttctcgtttactcaattagtgaaagtcaat	taaattatagtttacactttttccttttttccataatttttaataactttttttttcaaattttaaccaattttttcagaccttcccagaaaaaaaactcaaacggcttccacagggcatgacagccgaggcggatctgttagagggatatgatgaggtaagagatttagagataaaaatacactatcagttacaccgta	eta
caatgatgatgactaatcaagaatgtgcaattcatacaatactcggcgaataactcgtttgagtgtcttttagactattctttttgtcattatgtttatcactagcttcctgcttaagctcgcttgtcaaattatagtttcctgttttatttacaccaacaacacaatttttactttgttggtactgttcttgttctttc	caatggaacaaggaagtatattgataagagtttaaatcagtcaggacaaaatgacagtttgattgtagcaacatactttcaggtaaaaatgttagcttctattaaacggatgtttacaattaaacggatgtttattttaaatacagatattaatttttagtctttcttctggtaattgcagaagagttttaatacgaaag	eta
