ctgtagttttcgctacgagatattttgcgcgtcaaatatgttgtgcaatacgcattctcaggattatgtgttccggtaataaaatccatcaatttcagaattttttcttctagaaacagtgttttttattcgaaaaagtagcctgggaaatgctgattttcggtgtaaaattttttgtcgatttttttgcgcgggagttc	tgtagttttcgctacgagatattttgcgcgtcaaatatgttgtgcaatacgcattctcaggattatgtgttccggtaataaaatccatcaatttcagaattttttcttctagaaacagtgttttttattcgaaaaagtagcctgggaaatgctgattttcggtgtaaaattttttgtcgatttttttgcgcgggagttca	EtaKappa
ttcattttctaaaaaaaaatttttttggatttttcgattttcagtgaaaaactacaaaataatgagaaaaatgggatgaatttttgtgatttttctttcgttttttttgattaaaaaatcgaaaaaaaaaatccaaatttcggcattttttttttccagaaaaatccaattttttaaaaaattttctcagaatttccatg	tcattttctaaaaaaaaatttttttggatttttcgattttcagtgaaaaactacaaaataatgagaaaaatgggatgaatttttgtgatttttctttcgttttttttgattaaaaaatcgaaaaaaaaaatccaaatttcggcattttttttttccagaaaaatccaattttttaaaaaattttctcagaatttccatgc	EtaKappa
tcaacttggttctcggttttcaattttacctagaactttttacaattcattcttcacgagaatcctagttttttgtttttttataactacacgtgcattgtttttttttttttttttttggttttttttttctgaaaacatttttccatttttggcttgcacaaaattttaatcgctctatttctgaaatgacaaaatat	aacttggttctcggttttcaattttacctagaactttttacaattcattcttcacgagaatcctagttttttgtttttttataactacacgtgcattgtttttttttttttttttttggttttttttttctgaaaacatttttccatttttggcttgcacaaaattttaatcgctctatttctgaaatgacaaaatatca	EtaKappa
aagacgtcgtcgttgttcgattcaagctcctgaaaaaaagagagaaaatgaaaagaatcaattacaagggcacgttatgcgtgcgcttcgtacaccaccgtcagttccggtaacttgatatggataattggttttaaagtttctaaacttttcatctaatttttctatttatagcacaatcctaaaagctggctcataat	gtcgtcgttgttcgattcaagctcctgaaaaaaagagagaaaatgaaaagaatcaattacaagggcacgttatgcgtgcgcttcgtacaccaccgtcagttccggtaacttgatatggataattggttttaaagtttctaaacttttcatctaatttttctatttatagcacaatcctaaaagctggctcataattttgc	EtaKappa
aagcagtttctaaaaccgatttttcaggacacgcccggattcattgtcaaccgtctcttggtgccttacatgtttgaggctcttcgactttacgaacgcggcgatgcttccatggaagatattgatgttgccatgaaactcggtgctggatacccaatgggaccatttgagctcagtgactacgttggacttgacacttg	gtttctaaaaccgatttttcaggacacgcccggattcattgtcaaccgtctcttggtgccttacatgtttgaggctcttcgactttacgaacgcggcgatgcttccatggaagatattgatgttgccatgaaactcggtgctggatacccaatgggaccatttgagctcagtgactacgttggacttgacacttgcaagt	EtaKappa
tggaaaaaataattgaacaaaaattaaaaaaaaaattgccaggatatggacggagtttattttgaaattttaaaattttaagttcggaattttgaataattttttaaaaaacttttgggtatattgaaaataatgaagacaattttttgaattaaggaacaaattagaaaatgttttgaacaaatttttgaatattgaaa	ttgaacaaaaattaaaaaaaaaattgccaggatatggacggagtttattttgaaattttaaaattttaagttcggaattttgaataattttttaaaaaacttttgggtatattgaaaataatgaagacaattttttgaattaaggaacaaattagaaaatgttttgaacaaatttttgaatattgaaaaaaattgaaaaa	EtaKappa
gctttgacaaatagaaggtgttaccattcataaaatgctttacgacttatttgatcttgaagaaaattggttttttatccaaaaataaattttgcaaccctccactttaactacaaattcaaaaaaaaaagtttctcagatatttttccaaaaatctaaaatacgagctaagtacagaggagttttttcaaaaaatgttt	ttacgacttatttgatcttgaagaaaattggttttttatccaaaaataaattttgcaaccctccactttaactacaaattcaaaaaaaaaagtttctcagatatttttccaaaaatctaaaatacgagctaagtacagaggagttttttcaaaaaatgttttttaaagatttcccactaatttttattaaggcaggaatt	EtaKappa
atatttgaaggtgatttcaaaaaaaaaaatagtttccagccgcttgacaagtcggtcaaatttcaaaatttaactaattttaggtcacttttttgagccgccataactttttttttttgagaagttttcaagaagtttcattgtgaaattcggtgttttcagacaattttgagaataataaagcaatgaaaacaattcga	gtcggtcaaatttcaaaatttaactaattttaggtcacttttttgagccgccataactttttttttttgagaagttttcaagaagtttcattgtgaaattcggtgttttcagacaattttgagaataataaagcaatgaaaacaattcgactttaccactttaaaacatggttttggtagaactttggtgatttttggaa	EtaKappa
gtgagatttttttgaacaggagaaattggaactattttcagcattcttcagatgctccaatcgctggatcttcttgatttttcgccgctttccgattttgaagaatctgtgcacgcatttcggctcttcgttgctcagcaagtgctttctgaaattgaaaaaaaatcattagatttgcactcctctcggacaaaaaaacc	tgctccaatcgctggatcttcttgatttttcgccgctttccgattttgaagaatctgtgcacgcatttcggctcttcgttgctcagcaagtgctttctgaaattgaaaaaaaatcattagatttgcactcctctcggacaaaaaaaccattttttgtactatttttggaaagtcgattgaaaactttccaagaagttttt	EtaKappa
gagcacatctacagggtgggatgtactcacaagaagggggtataagcaaaaaggagtgaatgacagaaaaacaattgggagtttggatgaacggagacccggcgtttcccctgagcaaagaaagagagagcgtgatagaggcggagacacagacaggagggagaccattacagatcgtctcctatagtgggctgccggcc	tgaatgacagaaaaacaattgggagtttggatgaacggagacccggcgtttcccctgagcaaagaaagagagagcgtgatagaggcggagacacagacaggagggagaccattacagatcgtctcctatagtgggctgccggccgggggcgttgtggacctgtgggaagaagggaagaagggggagacgaccgcacgggc	EtaKappa
aactcggaagattaatatcatttttcaaagtttatcaattctatatatttgaggttatagaaattttgaattacaaaaaaattttagaagtttgaacatgcagacaaaaatcctaaaagttggaaaaaaactttgacccaataaaattctataaacacttttccattaatgttgcgtaatatcaatgaaatttatatgat	tagaaattttgaattacaaaaaaattttagaagtttgaacatgcagacaaaaatcctaaaagttggaaaaaaactttgacccaataaaattctataaacacttttccattaatgttgcgtaatatcaatgaaatttatatgatagtgtgatatttgtgattaaatttgataaagataagagacgtttgcgaacttgaagt	EtaKappa
tgggcgtggtttagtacgatgatccgaattcccggtaactgagaatcttatttgtttaagggttgaggtactatttttctatttttttgcaaaaaaacatcataaattgctgatttttaacagttttcatgagcgtaatatcggagcatcgtactagcccacgcccacttttagtacgatgctccgatattccgctagtt	aagggttgaggtactatttttctatttttttgcaaaaaaacatcataaattgctgatttttaacagttttcatgagcgtaatatcggagcatcgtactagcccacgcccacttttagtacgatgctccgatattccgctagttaaaattaaccgaaaatactgtcaaattatatttgaaacactaaaagctcataaaaac	EtaKappa
atgttttagtggtgtctcgtcttcatagagcacagtttgataatgaaaaattacgacaagggagtcaatacagtggctaccgtatacactttttccagtatttacccaggaatagaatgcggaatttctccgaattgacgttaatggaagccaataatgggtgcaaagttgacttgaaaatggtgataaggatgattcta	gagtcaatacagtggctaccgtatacactttttccagtatttacccaggaatagaatgcggaatttctccgaattgacgttaatggaagccaataatgggtgcaaagttgacttgaaaatggtgataaggatgattctattgcggttttacgacctggttttatatgtttcgccacgaaaaatttggcgaaatattactg	EtaKappa
gtgacgataaagttcaaacaaacacttgttccttcctatcattgtcacgtgccacgtgctcacaggatccggagccaacccctgaagcataccacaaaagtgcacctgacgtctcacgcagtttcaggttaactatcaaatttcagtccttcactatttctctttagaacaattttatcgtccacaaaatctaaaatctt	caggatccggagccaacccctgaagcataccacaaaagtgcacctgacgtctcacgcagtttcaggttaactatcaaatttcagtccttcactatttctctttagaacaattttatcgtccacaaaatctaaaatcttaacgcctcatccaattaacttcaaccttcaagataactgtaacattcacacttgaatccaat	EtaKappa
ttatattttccggtacttacaagcgaagtatttcggacttctggatgaatgtgaaattgctatcatcagtaagttattgcaatactttggaggcccgtaaatttgctccaagtaataatttttaaaatttttaatgatttttaggctatttcaaggtaggcgagtattctggacgctttttggaagttcgtttttttttt	tcatcagtaagttattgcaatactttggaggcccgtaaatttgctccaagtaataatttttaaaatttttaatgatttttaggctatttcaaggtaggcgagtattctggacgctttttggaagttcgtttttttttttggaaaaaaatctgaaatctcttgattgaatgagttggacgagtgaaaagttgggagaaaaa	EtaKappa
ttttgctaggccaccaacaaaagcaaataacacattttctaggccaccaacagaatttcaaatttttctaggcctttaactcacatatttcacaatggaagcggcggcgaacacgatgaaggctacaatgagaatgccaataattatgaatatcactactttggtccatggcgtcgatgatgctgcaaaaatggaggtac	ttttctaggcctttaactcacatatttcacaatggaagcggcggcgaacacgatgaaggctacaatgagaatgccaataattatgaatatcactactttggtccatggcgtcgatgatgctgcaaaaatggaggtacaaatatgcaaacgcgctctaccgcactaccagtgcggtagagcgcgtttcaaactaacagcca	EtaKappa
cagttgattttacaagtaccacaaaaggctttctcaaatttcggtaattgaaacgcaaatttcctctgtaaaaaatgaaaaaaaatgtcgaacaacttatttcgtcattttgacttgaaaaaattttttttttaattctcaaacttgtaatccaaatccaaaattttgaaaaatgttagaaaaaattctagggtgaaaca	ctctgtaaaaaatgaaaaaaaatgtcgaacaacttatttcgtcattttgacttgaaaaaattttttttttaattctcaaacttgtaatccaaatccaaaattttgaaaaatgttagaaaaaattctagggtgaaacaccaatgaaaagtatattaacacactattgagaatatgtgtacttcaaacattaaataaaatta	EtaKappa
gaggggtcgtcgtggagagagtgtagagaaaaaaaggaaataaaaagagacggaggcatcagttgtccccctattttcaaaaccctccttctctactctctcatcggccgccatagctcagtcggttagagcgtgggtctaataagcccaaggtcgcaggttcgacccctgctggcggcaaactttttgagctacttttc	tgtccccctattttcaaaaccctccttctctactctctcatcggccgccatagctcagtcggttagagcgtgggtctaataagcccaaggtcgcaggttcgacccctgctggcggcaaactttttgagctacttttccaaaatttaaatttttttttgatttccgactagtttgaagtgtctagactaacctcgttttga	EtaKappa
tgaaactctccgtatactgtacttgactcgacaagtcgcgaagaacatccgaaatctcctaatttgagtacggtacacttatcgaggaatatgttcgctggctttatatcacgatgaatgattttatgagagtgaagatactgtacagcccgcaacaagctattcgtatattgtcgaaccattttcaaatccatttttcc	gagtacggtacacttatcgaggaatatgttcgctggctttatatcacgatgaatgattttatgagagtgaagatactgtacagcccgcaacaagctattcgtatattgtcgaaccattttcaaatccatttttccgtgacaaattcgttcaagtgtaccctgtgagcaatattccatgaatatgatgacgtcactgtctt	EtaKappa
tccatgtcgttgtacgagtcttccatggctgaaatgcggaattttagttgaaaaatccgattttttggttaaaaatgagctgaaaaacgagaaaaatcaagaaaaaacgagaaaaaccaagagaaatcaatttgaattcccctccaaaatgcgagaaatgatgaggtttcgtcacggattagagacaatgggaaaggtgg	tggttaaaaatgagctgaaaaacgagaaaaatcaagaaaaaacgagaaaaaccaagagaaatcaatttgaattcccctccaaaatgcgagaaatgatgaggtttcgtcacggattagagacaatgggaaaggtggagacgcagacgagaaaggtgcagtggagcgcgcttgcactcaaatttccgcgggaaaaagtttcg	EtaKappa
tcatcaggatatgagaccggttcgaccggtgcaacaccatcgagtgcaatgttgttgcttcaaatttgtttggccaccatggagctacgaacaagcaccaccaccacagccaatttacagaaacatctgaaaatcttgctcaaccttgacaatgtttgatattcttcattttaatctgtatctaggctcaattctttgat	tgtttggccaccatggagctacgaacaagcaccaccaccacagccaatttacagaaacatctgaaaatcttgctcaaccttgacaatgtttgatattcttcattttaatctgtatctaggctcaattctttgatttttgcaactctatttacacccgtgttcctcaatttctccattcaaattctcaagttcactgtcgc	EtaKappa
ttcattctattacaataatttatttttttttaacaaaaaaaaaacgaattctgatgaaaaagaaaaacgaagaagtgcctgaaaaaagatgaataggaacgcaattccacccgatttccttcctttcatcgtcgcggatatatttttcatacaaatggaaaagagcagaaaaataaaagaaagagagtcagtcagtaagc	cgaagaagtgcctgaaaaaagatgaataggaacgcaattccacccgatttccttcctttcatcgtcgcggatatatttttcatacaaatggaaaagagcagaaaaataaaagaaagagagtcagtcagtaagccaaggaatataatacctggtcgattggatgaaatccacgtactttgaggaaataaaaaccactaccg	EtaKappa
tatttaactaaataggaaggaaaatgaacttttaaattaattatttaaaacaaaataaaccgggcaataattctgcacacacaagaaaaaccagaattctttttcttggcgttgtcgtggaataacaaaatgaacaaagaatgacatacaccggaagcatgcttagtacctgctgccccccggcaactcgcttgtttggc	aattctgcacacacaagaaaaaccagaattctttttcttggcgttgtcgtggaataacaaaatgaacaaagaatgacatacaccggaagcatgcttagtacctgctgccccccggcaactcgcttgtttggccttcaatcgattagcgccctgccggtgagtgctgacgcatctctcgtgtcacttgcacccgcttttct	EtaKappa
tcgatatttaaagggcaaagtaaagagaataaacaacgcgatatcaattttgcgatgcaggtgcgctgtaaacgagctcttgcaaaataaattcaaattccttgttttaggtgataattcagggaattgttatggtgttttttggtgtttggtatgtttccggttattcgtttttgcctggcaacaggctggattggaaa	taaacgagctcttgcaaaataaattcaaattccttgttttaggtgataattcagggaattgttatggtgttttttggtgtttggtatgtttccggttattcgtttttgcctggcaacaggctggattggaaaatttttatgacaactacggtctcgtcttctttaactaattgcctagcaccgttagtgctatatttcac	EtaKappa
aagctcaaatttaacatcagggaaatttttttgatttttttcacttagatattcggaatcaaggaaaaatttggagtcatttaaaaatattacccagaattcggtacctcacctttaaagcatttcttcaatcctaaacttttgaaaaatgccaggctctacaaaaattggtgtcacaccaaattttcgacgttgaaaaa	ttggagtcatttaaaaatattacccagaattcggtacctcacctttaaagcatttcttcaatcctaaacttttgaaaaatgccaggctctacaaaaattggtgtcacaccaaattttcgacgttgaaaaatcaaaaaatcatggtccaaatgtgttctttgaaagctgtgaaacttttgaaattagatatggaatacgtg	EtaKappa
tacttatgcccagattcggtcatcgaagcttccccctcttgaattggtcatcatcatcattcgatccccgcaaaaaaaccagttccccttccattttttgcgaccgaataaatatgtgtcaagctgttttgattgtgcaattttcgtagtcgccgtcttcaaattagcctcaagcttcttcttcttcttctccgtattgt	caaaaaaaccagttccccttccattttttgcgaccgaataaatatgtgtcaagctgttttgattgtgcaattttcgtagtcgccgtcttcaaattagcctcaagcttcttcttcttcttctccgtattgtctgcggcgggagagacctaaacaggttgagtcgttgtcgtcttacgaaattgaatgcgtcacacacattt	EtaKappa
cactgagtccaaaatcatttgtacttgatctgtatctgttgcacacgtctgatgcatgtaaatcgtcttttctggatttgcattcaatccatcaaacttttcctcaatatatcgacacgattcgtcgtaggtttgtgcacctgaaaatatatgggcagagtgtgaaaaagttcaattaaatcttacctttatagtctggg	tctggatttgcattcaatccatcaaacttttcctcaatatatcgacacgattcgtcgtaggtttgtgcacctgaaaatatatgggcagagtgtgaaaaagttcaattaaatcttacctttatagtctgggaatgcggatttaattgaagttcttttaatcttctcggcaaacaaatccttcttatttaagaaaagaatca	EtaKappa
gaaaaaatcgacttttaagccgaaaaaacgtctgaaaattcgaaaaattgtgtttcaaatcaaatatccgagaaaatatgaagaaaacccattcaaatttgtttgcaaggggatttaaaaataattcgaatttttgccttaaaattgcaaaaataaacattaaaaatttagaaaaattctaaaaattttacaagtgaatt	gaaaatatgaagaaaacccattcaaatttgtttgcaaggggatttaaaaataattcgaatttttgccttaaaattgcaaaaataaacattaaaaatttagaaaaattctaaaaattttacaagtgaatttgatattttggggctgttttctagcatttctggcaaaatttgaaacaaaaatttgtcgcgtcgagactccg	EtaKappa
cacaaaatctttcatgaaaccactttccccaaattactttcaattgttttttgtactttatagatctgatcgttttttcaaattcaagcatttctcaggaatcttcttttttgcatgtctcaggaaagtcaccaaaattctttactaatctgcaagttttttatttgaatttttctgaagtttttttattagttaaataa	ttttttcaaattcaagcatttctcaggaatcttcttttttgcatgtctcaggaaagtcaccaaaattctttactaatctgcaagttttttatttgaatttttctgaagtttttttattagttaaataaattttacatttctaaagtttttattattttcagtcatttctgatgcattcatataacgttattataaaaaat	EtaKappa
ttggaggtaatactgaaaatacgttttgtgatttgttgcgtttggtttaggagcgtacaatgtacttttcaattctggcaaaatttggctgaagtttcttattcaaactttgcaacttctcgtgtttctatgaatagtaattttctttcaaaattaatggccctaactagaaaattcgaaatctaacgtttgactgtatt	tctggcaaaatttggctgaagtttcttattcaaactttgcaacttctcgtgtttctatgaatagtaattttctttcaaaattaatggccctaactagaaaattcgaaatctaacgtttgactgtatttaaatattaacttgatttacgatctagaatactgtactcatatctttacgtttgcaatcttttttaaattcaa	EtaKappa
agttgtcgaaaaaaattaactaaaaagtatagtatttcctccagagtagaaacaaaaaaactttcgtttcgttagatagctcgtaaaataaaaccaaaatcgttaacgttacagtacttcaaagtcttatacgctctcagcgtagctggtctcgaagcgattacctccgaaattatttttactctgagaaataacaaaat	agatagctcgtaaaataaaaccaaaatcgttaacgttacagtacttcaaagtcttatacgctctcagcgtagctggtctcgaagcgattacctccgaaattatttttactctgagaaataacaaaattaataaaaattaattttcagaaaaaaggcgattgacgatggaggggacagttcgatgagtgatgaacgccgac	EtaKappa
caggcatatcaagttttattgtaggtaaacgtatttcaggaattcaaaaattggtgaaaataaaaactatggtcgttcagtattatttgaaagttgtagtttttacagatctaattttgaaagaaactggttgaagaaaactattggattatgtcaatcgatatccttcttaattggaacattcgaatttaagcaaacat	gttcagtattatttgaaagttgtagtttttacagatctaattttgaaagaaactggttgaagaaaactattggattatgtcaatcgatatccttcttaattggaacattcgaatttaagcaaacatttagcaatcaacattcgttgactttttggttttttcaacttattgatcctttcagaaatgacaacttgttatat	EtaKappa
agttttaaatttttcgttgtctactttcctccgactagtttcatttttcacgtccctcaaatccacttttcttctgttttcccatgggccaagagttttgcttttaactccgcgttttcgttatttttttcagctgcattctgctattgtgcgtctgttccccgttgaaaaactgataacgatatgtgcgtgtgtctgtt	gttttcccatgggccaagagttttgcttttaactccgcgttttcgttatttttttcagctgcattctgctattgtgcgtctgttccccgttgaaaaactgataacgatatgtgcgtgtgtctgtttgttggctcgagctggcgtgatatgataaaagtcttatgcccgtacaaatattttatagtcaaccatttttcctc	EtaKappa
tgcgtttgtagttcagtaatacatgggaaaagaaatgtagactgatttgacaaaaaaaaacgaatttcaagatgaaaaacgtacatagccacttgtttggtgcagaatacgaaattagagttttgaacgacaagtgataaatgatggggaaaagggagggtgatgtggaagatcttttcagtttcttgaaggtaaagaca	aaacgtacatagccacttgtttggtgcagaatacgaaattagagttttgaacgacaagtgataaatgatggggaaaagggagggtgatgtggaagatcttttcagtttcttgaaggtaaagacaaccgcgttggaatatattaaatacaaaaaggttatgaattggtgagacggaataaaaaacggagttggagatagga	EtaKappa
tgggaacaattctgtaaaccatgcggaatttgaaacaggaaacaaagattgtttttaagcaaactaaacccagtgaacataggagttttacacaattagttcaaaatgatattgactgtttttgtcaaaaggtctactgggcatgtgagaaaactagcaccggtaagctaattttcataactaatgtggccattgtacaa	acataggagttttacacaattagttcaaaatgatattgactgtttttgtcaaaaggtctactgggcatgtgagaaaactagcaccggtaagctaattttcataactaatgtggccattgtacaaaacaaaggttaactttacctattcgcaatctaaccgcataattgttataactatattctgtagtccaaactttctc	EtaKappa
attctgcattaaaaaaactaacatcaaagtgttgagaaattacataaaggaatctattggaggaactgggaatgtgatgaaatttagaaaaataaaaactaatcgattttttcaacatgacagaacattaaaaacaaatacttgttgtggtctaacttatcatttaccgaaaatcgtatgagccaactacacttaccagt	tgaaatttagaaaaataaaaactaatcgattttttcaacatgacagaacattaaaaacaaatacttgttgtggtctaacttatcatttaccgaaaatcgtatgagccaactacacttaccagttagtagaaaaagtagaagttttaaaattaatttttggcatatttttcatccaaaaattagtccttctttatataaaa	EtaKappa
aagtcatttctgtaatttgaattaaaaaattgtctaattttttaagaaaattttatgaattttaattagacttgcaattcattcttaaaggaagatttgattgaaccaattatgattttaaatataaatataatcttaattttggttttttttttcaaaaatgggacatcacttgcggtcgaagttctcacacgatattt	tcattcttaaaggaagatttgattgaaccaattatgattttaaatataaatataatcttaattttggttttttttttcaaaaatgggacatcacttgcggtcgaagttctcacacgatattttggcaatcttccagtataacaagaacatgcactcacctttgttcgtaaaaatatttttcgatatttgacggaatatat	EtaKappa
aagttaccgtacttttgcagataattgccaaacttcggtataaggttgtcaaatgttggcttattttttggcagccttcatctgaggctagtacaatagaacgcgcttttcctaattttgttttcaaattcatattgaaatttggtaaaactgacctaccgacatgcctacctattccatctttagccgacttgatcaga	catctgaggctagtacaatagaacgcgcttttcctaattttgttttcaaattcatattgaaatttggtaaaactgacctaccgacatgcctacctattccatctttagccgacttgatcagatgtcattaggtgtcattagacagaagttcaaggcggcttgttgcaccgccccacaatttccgggttacaagactcaca	EtaKappa
atgcttcttgacttgattgttccatttggattagtttggcgaggagcgaatgacaaggatactgtttgtaaactgaaagaagaggcacgtggaaagaaggttagtgaatatgttttcttttgtcactagccctcctagcggaattccagaagcacggcaaactgtaagtttcaggcactttttcaagttcataaaattaa	gaagaggcacgtggaaagaaggttagtgaatatgttttcttttgtcactagccctcctagcggaattccagaagcacggcaaactgtaagtttcaggcactttttcaagttcataaaattaaatattattttcagatggaacataccattttttacttttttataccaattttagatcaaaaatttggattttcttgttg	EtaKappa
tttatggtaatttttttaaaacttttgtttcaaaatagaaaaacacgaacgtgtatttggttgtttaagacttttttaatacattttctatcttaaaaatgagaagaaaacgaaaaatctcgctgaataaccacactttcaacccatacattttaattttaatactttcagacttgtcactggatcacgagataccactc	atacattttctatcttaaaaatgagaagaaaacgaaaaatctcgctgaataaccacactttcaacccatacattttaattttaatactttcagacttgtcactggatcacgagataccactcttcgtgtatgggacgtagaatccggacgtcacctggcaactttacatggccatcatgcagccgttcgatgcgttcaat	EtaKappa
atggttcttgctaggaaactctctactcttcctggaaatgaaaaatacgattacacattctgttttctggttttatgaaaaattgagctaacaattataacattatgataagaaaataaagaagtttgtcaaaaaaaagtgttttctaactggatttaggagtaattgaactatttatttggggaaattgcgtataaaat	aaattgagctaacaattataacattatgataagaaaataaagaagtttgtcaaaaaaaagtgttttctaactggatttaggagtaattgaactatttatttggggaaattgcgtataaaatttgatcgaaaaaataatttacgaaaataaatgtattcttatttggttttatttatttatcctgattataaaaaatcgtg	EtaKappa
tctactaaaaccaattgagaaaaagtcgagatttctgagactttactcatcagatggacaacgtagtacacgtatagaatgtgatgagcacacaacttgtgctcaaatatgtcaacaattttcatgtgatgtgattactcttcaaattggtaattaccattttcggtgagtcatttcctcgtaattgtaaaaaatgagga	gtgatgagcacacaacttgtgctcaaatatgtcaacaattttcatgtgatgtgattactcttcaaattggtaattaccattttcggtgagtcatttcctcgtaattgtaaaaaatgaggattttttccgaaagtaagctaataaattattcctttcacagttaaatggaccgcccgtcaagtttaattgaaatgaaatta	EtaKappa
ggactaaacagtgaatacagttctgagtatttttgaaacatgtgaatagctgtaataaagggtaaaaaaaataccccgtcacaaaaaaaacaatgataagagttactcttgtatgtagtattgcttgttttttaccttaaaaaaagttaaacttatataatttttttattaacatgacttagatgtaaaactttaaaaaa	acaaaaaaaacaatgataagagttactcttgtatgtagtattgcttgttttttaccttaaaaaaagttaaacttatataatttttttattaacatgacttagatgtaaaactttaaaaaaatcagtagaacattattcgaagacgattttttgagcataaaaagttgcgcattggattatttaatctacgacgattattt	EtaKappa
atatcatcgatatccttctgaaaattaacctatttgaaattaaattattttttcccatttttttttgttcttttttctcaattaatatcagtcactattacctgatatatcattacattgacgaaaaagattggagtgttgaatctgatttgataggcgaagttggcagtttggaggcggtgtcttgaaaattttaaaat	taatatcagtcactattacctgatatatcattacattgacgaaaaagattggagtgttgaatctgatttgataggcgaagttggcagtttggaggcggtgtcttgaaaattttaaaataaaaaaaaagctttaaaaaaaattgaattaagccaaaaaaaaataaaatttcggaaaaattttcggatttaaaaaattaaag	EtaKappa
ttgagatggagaatgtttttaagaatatagagttcatgaggccaggggacgaaatgtacagcgagaaggggtcacatttgaactactggtggtgagtcaagcccctatcgcttcgagacccatattttcagaattttatcttttaggcccattttctaaaagtactctagctttaggacatttgagactaaagcctttaa	tactggtggtgagtcaagcccctatcgcttcgagacccatattttcagaattttatcttttaggcccattttctaaaagtactctagctttaggacatttgagactaaagcctttaattctatcacattagaccagggatgagcggcaaacgattttttcctgcaaatcggcaaactggcaaattgccggaattgagaat	EtaKappa
ttgaatttttgcgatttttgaggcttggataccgtacctggtctcaaaactatcgaaactttacagctacagtaaccgaaagtgtttcacaattttccacgattttttttgtttgatagtaggcgttttccggaacaaaatttgaagattttgtattaaaaatcatgaataatcgtagcaaattgcgaagttcctgtgag	tttcacaattttccacgattttttttgtttgatagtaggcgttttccggaacaaaatttgaagattttgtattaaaaatcatgaataatcgtagcaaattgcgaagttcctgtgagtacggtagctgcaaagtttcgtgtcgagacccggcaccgtatttttgcgccagtaatcacaaaattcaacaacatggcaataat	EtaKappa
ggcagacgtcttggtttccgtctttttttctgtttttggattgaaaaatgtcaaaaagtggtcaatttttgccaatttttcaagtgattcatatgtttttagggaaaaaataatgagaaattcgaatttttcgttgaattttacctcggaacttgagattttcaagttacggggtactctgtagctttgcaaatacacaa	tgattcatatgtttttagggaaaaaataatgagaaattcgaatttttcgttgaattttacctcggaacttgagattttcaagttacggggtactctgtagctttgcaaatacacaaaactcagatttccatgaaaaattccaaaatttctactttttttcaataggtttcccaaaagtttgacctaaaaattgtgctcgc	EtaKappa
aggccgaaaccgacaccgagaagaaaaccgttgaaggcgtcaaggaagacactccaaaggtacgtaaaatattcaacattaactgtttctacgtatatttcaaattttgaagcaagttctagaaaaaccaagtttattgtaaatttacttcgtgtaaaacatataagtttagcaggtggttgtgtgcgaggctgatgagg	gtttctacgtatatttcaaattttgaagcaagttctagaaaaaccaagtttattgtaaatttacttcgtgtaaaacatataagtttagcaggtggttgtgtgcgaggctgatgaggagaagcacatcagtaactgcggctgggtaccaatggaaggaggcaactttgacaggtattccaaaattcagtttttgcgtaatc	EtaKappa
gtttgaaatttttcaaaaaattaattttctgcctcttgcccagaaaaagtggtttggtctggtgtttcaacaataatatttttgaaatcctcacaccttttttcatattccctcatatttttgtaacccaattctcactttgaagggagatacaggcgggagatacagttcgttgaagggttggctgccaacacatcgcc	aatcctcacaccttttttcatattccctcatatttttgtaacccaattctcactttgaagggagatacaggcgggagatacagttcgttgaagggttggctgccaacacatcgccaccccacccacagagagacacacatttacgaaccaatatattcaaatattacctcctgctctcagttttcaagattttatgatga	EtaKappa
accaagaggaaaatggggattttccactaaaaatcgacaatttttagagaaaaattgtgtttcaactaaagaatccggaaaaatctgaattttttgcgaaaaattttggtttttagggtttcttcggaaagctatgcccgaattttcattttgaacccatttttcgcaggtttttgatgttttttgacgattttaagtgt	gaattttttgcgaaaaattttggtttttagggtttcttcggaaagctatgcccgaattttcattttgaacccatttttcgcaggtttttgatgttttttgacgattttaagtgttaaaatcggattctccactaattttcacccaatctcacacgtttttagctcaagaaatgttggtggccgaactttttggtttttct	EtaKappa
gtctgtagtgtcttcgtgcattgaaagtgtaaagaattccattgcgtgcttggcggagggaagttcgattccttgggcgactatgtcgtattttcgctccaaaaaccggactgcctgaaagaaaattgattttgaagatttttataaatgaaaaaaaaaacatcatttcacaaatttttggaaggtttttttgtttttcg	cgtattttcgctccaaaaaccggactgcctgaaagaaaattgattttgaagatttttataaatgaaaaaaaaaacatcatttcacaaatttttggaaggtttttttgtttttcgaaagattacaattatatattttgaatttttaaattacagttttaaatatttaaaaattatataaaaattaccgttttaaatatttt	EtaKappa
tcgcataacatattttatgtcttgacggattaggctcctcgaaagtaattggtttctatttcacaccttagatgtagaagtgaaatgagtaaatttagcattacttggaatgtacgcaattcggatttccttgtgacgtgcacttaactataaagttatcttaaacctttctgacttttgacaacgttgttgctcaatcg	gagtaaatttagcattacttggaatgtacgcaattcggatttccttgtgacgtgcacttaactataaagttatcttaaacctttctgacttttgacaacgttgttgctcaatcgcacatctccattttgagtattgtagctgcgcagttgtatttttatcatgcgtatatgaatacttgcgaaatggcagattaaatttg	EtaKappa
gcccatcatcataaatatgtcttaatgccaataaactcggcgtgttcgccagaatcgcttgccgccagccaggatcctgctcgtgcgaaatgaacattttcgtctgatattctccaataaccgtgtataatccgtcattctcgtcaaattcctcaaattgtgcaaaatgatcttgatgtagttttagagccattttaaca	aaatgaacattttcgtctgatattctccaataaccgtgtataatccgtcattctcgtcaaattcctcaaattgtgcaaaatgatcttgatgtagttttagagccattttaacagctggagacaccacacatcggagcatatccatgtcagtgaacacccattcgtcgcgttggcaagttattctgaaaatggaaaattat	EtaKappa
aaaactgtgtttaaaaaatcaaaaatttcagaaaaaaatttcaaaaatttccaaaaaaaaaattttcgaaatattttcagaaacctaaataattgattttttatagaaattttagatgtaagcgtaaaaaatcaatacataaatcgttgaaaattgggaaagtcacgggattttcgaaaaatgtgggtcgatgcaccatg	aataattgattttttatagaaattttagatgtaagcgtaaaaaatcaatacataaatcgttgaaaattgggaaagtcacgggattttcgaaaaatgtgggtcgatgcaccatgagagtattttcaagtaggctctgcttagatatgcttcaaaataaaaatagtttgaaaattattttcattaataaatttgattaagca	EtaKappa
tgcggcttcagataatcgtcgagcagaagattttccagatttttcggatttttctcccctttttcagaatttcccaaaattttgcggcggaatgacgtggcaaacacggcttcttgcaaccgatgacgtagctcggacattgaagaatccacgatttcttggagaagctcatcgagcactacggtgtcgatctggaacaa	cggaatgacgtggcaaacacggcttcttgcaaccgatgacgtagctcggacattgaagaatccacgatttcttggagaagctcatcgagcactacggtgtcgatctggaacaaactacaaactacaaaaattcaattttttggagtttttttttgaattcccaaaaaaaagttttttttaaattttgtgtagatttttca	EtaKappa
cgtttgcctacgttttttcccaccgtcaatttctgcagtaggcttgtaggaaagatgcatgcaggcatttttatgtctgatccacgattgctcaaaatgtccaaatatcataattaaatttttcaaaaaaataatcccagttgtaatagtgaaaacttggtttcacacagcaaaatgtgaaagtcggctaaaaaagattt	ttgctcaaaatgtccaaatatcataattaaatttttcaaaaaaataatcccagttgtaatagtgaaaacttggtttcacacagcaaaatgtgaaagtcggctaaaaaagatttctgcgatttttatacctcagttccacatttttggaaattttgacagtatcaaaacgtcgactgaaaattttgaaaaatcgaaaattt	EtaKappa
tatactttttctgaaacatgatacatatgctgcttaaatgctgaaattacctgattttcataacgagaccgctgaaaaagttttgaggtttccaaaattcaactttttcggtgaaaaagtcgagattttccaaaattcaactttttcggtgaaaaagtcgagattttcgcacaaaaagttgaattttgaaaacctcaaaa	tttccaaaattcaactttttcggtgaaaaagtcgagattttccaaaattcaactttttcggtgaaaaagtcgagattttcgcacaaaaagttgaattttgaaaacctcaaaactttttcagcggtctcgttatgaaaatcaggtaatttcaacatctaagcagcatatgtatcatgtttcagaaaaagtttaggttttgt	EtaKappa
aaaagtttattcttgaaaacgatgtggtacacgatcaatttttttggcatagaaacactttgacgacgttggcagaaattattttaagattgcgttgctatttttgttatgtattaatttatgcaatattaaaaaagcgatgtttgcgaagagtaaaacttttatcgctgttttcatttcaggttgtcaacattcctttc	attgcgttgctatttttgttatgtattaatttatgcaatattaaaaaagcgatgtttgcgaagagtaaaacttttatcgctgttttcatttcaggttgtcaacattcctttcgaagagggagtcaagcaattcggagttgccgatctctacaaggaggattaagacgacggtcacgaagacacactatcagacccaggag	EtaKappa
gcatagtcgtcatcatcgtcgtcgaagccactcattaaattacccacatcgaaaattgttgagtcgtgcggttctgcagcagccgaacttgattcctctacattctgaaaatataaatattttataatttcactttatcatttgtaaattacttctttgacgatttcgtatcttcgttgtttgaagatgaattttctgct	tgattcctctacattctgaaaatataaatattttataatttcactttatcatttgtaaattacttctttgacgatttcgtatcttcgttgtttgaagatgaattttctgctggacgatactcacgttgaacttcttcgttttcgtcgtcaccttcacagcagctccttctctgcagtagtctatgaaaatcaccgagtaa	EtaKappa
cttatgaagagccaaatacgggctttgctcagagtgctgagaaaactaacatattttgtgaatttttataatatgaaacctacctgaacttgtatgtgaataatacatcaatcagaaatagagaatcttgaagcactgtttgaaaaaacatccgaatgtttttcctaattgacattgaagtttccttgcttctctgtcca	ttgtatgtgaataatacatcaatcagaaatagagaatcttgaagcactgtttgaaaaaacatccgaatgtttttcctaattgacattgaagtttccttgcttctctgtccattctataaattttcagaattaatttgcatgatcacaataactattgaaataccttgcccaaataaaaccttaaaatcttggaaaacgta	EtaKappa
tatcaagcattcggagagcctgaaaaatgctaatatttcgccgtaaacgagaaaacgaccattattgttttccaaaacgctcaaaatataatttcaacaaaacttggttgccggttgcggaatagttgccgaaatttcgtcaatcgaaagttgccggttgccgaaaatttctgggctcggcaacttcggcaattgccggt	atttcaacaaaacttggttgccggttgcggaatagttgccgaaatttcgtcaatcgaaagttgccggttgccgaaaatttctgggctcggcaacttcggcaattgccggttgccgaaattttttggattcggcaacttcggcaattgccgattgccgaaaatcccggttgccgcacagccctgatacgaaacggttactt	EtaKappa
cttttccagtggttcttcaatttcttggagcaatttggtcgcctgtgtctttgctccggcagcgcaaaatagttgggcaagttgatatttttggaataagatcgccggatcagtggtgttttggtagacgagcatgatggagagaagggttccgccggttttggcagcggctgtgatactgaaagaaaacaaatgttttt	tggaataagatcgccggatcagtggtgttttggtagacgagcatgatggagagaagggttccgccggttttggcagcggctgtgatactgaaagaaaacaaatgttttttggtggaattttttgtaattcagttaatatttattggtttagaagcgtaaaaatgtagttttttttagaaaaaaaaaacagaaagcagtag	EtaKappa
ttatttctagaacattataattagagctttgcttttcacttgaaaaggtgcctgacaattgcatgcatttaccgggaatttattcgtttgaaatatttttgtgtcctctgtaaagctgatattcttgaaaattgcacagcttatcatgcctcaaaagctgtgattatttggttttttggtgttatgctgagtgcaaattt	aatatttttgtgtcctctgtaaagctgatattcttgaaaattgcacagcttatcatgcctcaaaagctgtgattatttggttttttggtgttatgctgagtgcaaatttggttgtctggtcggttgagcaaacgaaattctaagaccaagcacatttctgtttttaatcactgtagatcaaagaactatttctaaaaata	EtaKappa
cacactaaaaatgacgtttaatgcattctaaactatcaacacttcaagtaaagcattaagatggtttaaggaaaaagtaatcgaaataatttcagttaaatcattttctgatttatgactatgtgattcaaaaaatcaaaaacgttattcattgaatgtttcgcaacttttcttggttttgctgataaataagtcaggaa	agttaaatcattttctgatttatgactatgtgattcaaaaaatcaaaaacgttattcattgaatgtttcgcaacttttcttggttttgctgataaataagtcaggaatgtgtagtttaaattttaatcctacagatacgtgtgtgaaacatggaataaaaatcaactgatggtaccacaaatattttatcagagatcaaa	EtaKappa
gctaacaatgtgtaaaaacatatcaacaccggtgcgtatcctgtttttgaagtgttgttctttcaactattatacagaatttgccgaattatttaacattatcagccgaatatatatgttattataatgactttgatgagtaatattattcaaaagtctatacgctgtcataactttgaaaatttcccattgaagtgtca	aacattatcagccgaatatatatgttattataatgactttgatgagtaatattattcaaaagtctatacgctgtcataactttgaaaatttcccattgaagtgtcattgccaataacttttttcaaccgttcttttcaatattccagattttttaatctttcaagttaggagtattacgctgagataacatttcctattg	EtaKappa
ctaacactttcttcatgttcaaatactcttgggaccaccccgtgaaaaattattgggagcacccaaaaaaaacaacaacttttcgaaattcgcaggcctccattacaacgtgcctaccgtatgcctgcctgcctgacgcacaattgaagaattttgatgtgacctcaagtatttggtgtgctcaatttcaatctcttatt	ggcctccattacaacgtgcctaccgtatgcctgcctgcctgacgcacaattgaagaattttgatgtgacctcaagtatttggtgtgctcaatttcaatctcttatttttattggatcagtaaactttgaaacaaaaaggcacaaggcaggcagacagggccattttatgtctatgcggaagaaaaaaatctctacgtgtc	EtaKappa
tgcacgcgacgccgccgttgcccgccgaaagaaaaactatggtgtccgcagaactcgccaacgggaaacccatcaagcatctcatcgagaagttcgatgccggcgtcaactttgcagagcacaagccaaaatccatttatgcgcaggttctcgaagaaattggaggctccgcgcctagagtggatgaagtgttttcggcg	gatgccggcgtcaactttgcagagcacaagccaaaatccatttatgcgcaggttctcgaagaaattggaggctccgcgcctagagtggatgaagtgttttcggcgtcaaagaaggaggaacacgcggagactgaagtgacaaatgtcatcttcagaagcacttctactcacagtagcatcattgcgaacgggaaggagca	EtaKappa
ttattgatgtaaataataaaaataaacagaaaatatcagtcgaagcgctttagaaggaaattatatcatatctctacatcaacatacatcctacatcaaacatacatctactgagttctcttgggtttttatatggattggaataatatgtaaatgaacacataagaggtgattagcatctaatatgttaatcggaatta	caaacatacatctactgagttctcttgggtttttatatggattggaataatatgtaaatgaacacataagaggtgattagcatctaatatgttaatcggaattaacaatacaggagaaaactatttgatattattgatatttgatcatcgaaagagaggtctttcgacactcccaagaaagtgaagaaaggaaaagagaa	EtaKappa
tttgccggcctttgattatttattattattttgcatacaaatcataaaaatttaaattttttttgcaaaaattcacatttggagccattttacggacctcgaaagttggggaaaaatgcactggaacgttttcagagcgactttttccagttcaaactgctcctctgtcgctaaatttttttgtaggggcctatttagaa	ctcgaaagttggggaaaaatgcactggaacgttttcagagcgactttttccagttcaaactgctcctctgtcgctaaatttttttgtaggggcctatttagaaggcctacttccaaatggcatgcgtttcattcagaagtacaagattaagttgaaatacttcccttgttagctacatacatgcaccaatttttacttta	EtaKappa
catgcgaaggcacatttactagaaacaaaaatggactcaatcgtccgctaaatagagattacagttttttcgagtctctttcatgtccgatacactttgatcccttttaacgatggccttgttcaagtttttaagttttgtaatagccaacaacagaagtgaatattgtgtgtgggagagaaaaggacggacagcgcaaa	tgatcccttttaacgatggccttgttcaagtttttaagttttgtaatagccaacaacagaagtgaatattgtgtgtgggagagaaaaggacggacagcgcaaaaaatagctgttgctatacggaatgtctgtttttgagaggaagagaaacacacctcaaaggatagagacttcttttcgggtggttacctggatacggg	EtaKappa
ccattttcagctaaaatcaaaatttgttccaacttctcggtgccgcaacgtctggaacctaatttttatttattcatcactttttaataaatattgtggtctttcattgggcgtttattcgttaaataaaagttacattttgagccccaaagaccataatgtacttaaatcaacgaataaacgcacaatcaaaggccaca	gtctttcattgggcgtttattcgttaaataaaagttacattttgagccccaaagaccataatgtacttaaatcaacgaataaacgcacaatcaaaggccacaatatttattaaaaaatgatgaataaataaaaattaagctcgagacgtcgcggcaccgagaagttggaacaaattttgattttagatgaaaatgggcct	EtaKappa
tcgacaaattgccgtaattgaaatttccggcaaatcggcaaaccggcaattaaccgattcgcccaatttgtcggaaaaacgacaaactgtggttttgcacattttttttctggaaacttcacaatttcaattttcctcggcataattgtaatgcgccaaccaaacgagaaatgtactggtcataaaaaagtactcaccat	cattttttttctggaaacttcacaatttcaattttcctcggcataattgtaatgcgccaaccaaacgagaaatgtactggtcataaaaaagtactcaccattcaccaaaatcgcacaaatataaaacgggccgagctcggcgaacaacgacactccggtcacttcctcgtaacccgtcaccaataacgacgggattgtca	EtaKappa
cgttttaaatatttgataaatcatttttgtgaagaggaagttataaaatccaaccagattagtaatcccctttctttcaaaaataaaaatgctcgacaaatagaaaaatcaagtcaaagatcttcatataacttcctcacaggtgatctctagatttaaaaaaaaaaaagtgtaggaaactcaatctaatactagctgct	atagaaaaatcaagtcaaagatcttcatataacttcctcacaggtgatctctagatttaaaaaaaaaaaagtgtaggaaactcaatctaatactagctgctaggcgtgcaaaaaagtgccaccgcacttgaattctctcttcaaaactctccgattcacagatcataatcggatttcgccgttttctttcctttgttagt	EtaKappa
gtttttggacagtttttctatatttaaatttccattttctcaaaggaagttgagacaaagttcaatatatcagagtacttcaatgaaaatttccaataatttactcatacaattgcaaacgtagcaagaatagtgagttacaaataactggaaatttaaaaattagaatgaaaagttttggttgggttaaaaagaaaagt	tttactcatacaattgcaaacgtagcaagaatagtgagttacaaataactggaaatttaaaaattagaatgaaaagttttggttgggttaaaaagaaaagtttgaaaaattaatatgcaaccattcatgtcattcatgctaatgtcatgtttgatttatacttttctgagcaactgacgcaaaacaccgtaaaaccgaaa	EtaKappa
ttaaaaaatcgaaaaaaaaatcgaaattttgaaaatggaaaaaaatcgattttttcaaaaattttcttttaagaattgaatttcttaaaaacttcgattgtacgaaaaacacaattttttaaagaaaattgaaaaaaaaaataaatatttaatttttcgaaaaattcgatcaaaaaaaaattaaaaattcgatttatttt	tacgaaaaacacaattttttaaagaaaattgaaaaaaaaaataaatatttaatttttcgaaaaattcgatcaaaaaaaaattaaaaattcgatttatttttaattgaaaaaaacacaaacctaaaattatcaaaaaaaattttttttgaaaaatttgaaatttttcgagaaaaaaaaccaatttttaatttttgaaatca	EtaKappa
ttgaataaacttactatgtccaagcatttgcagatggctcatttgtagcccatttagaccaagtaaaacctggtgaggtatgcttatcaaccattacgaatgaatttgtaccattgcattcctcactgtcaagaattcctcgatctcttgaaacacatgctgcaatacgtcttccgtcgacagcaatagcgccacgagtt	tgaatttgtaccattgcattcctcactgtcaagaattcctcgatctcttgaaacacatgctgcaatacgtcttccgtcgacagcaatagcgccacgagttgccggtccaacacgatcgaactgttgtgccatttgtaaagagaacacattgagctcctcctcgttggcgaaggtagttacaactgcttcagtgttagaag	EtaKappa
aataagttcttgtttagatttttgaatttttgagatcaaattcgagttctccgtggttttttttaccccggggagttgtttttggggtcttatggtcatttttaagatatttgagaaactcgatgcttactgtaacttcgaaagtacgcaaacaccaagtattttacgacaaaattcacactttgcctagttttaatgct	agatatttgagaaactcgatgcttactgtaacttcgaaagtacgcaaacaccaagtattttacgacaaaattcacactttgcctagttttaatgctaaagctctgaaaattgtgtccacgaggtgaaaaataatggggagtccgaattttacaacgaaaatttacaaaaaatctgagaaagaaattaaatcgtacctttc	EtaKappa
tattaaaaactctgatgacccccatcccgtccccaatttggctttatttgatattcataatattctcacggaactctgtgtaataagttgttttcttactaatttttctaaccttttgaaattgtatgctacggattgtaattcatcttccctccctctctcactcgatgcatctcttttctcaatttttggtgttgctt	tttctaaccttttgaaattgtatgctacggattgtaattcatcttccctccctctctcactcgatgcatctcttttctcaatttttggtgttgctttatcaatttttctctactttttctgtgcaatcttcttttttttctcgaacaaaaattgttttaataatttttatttcaaaaaacaaaaaaaaatgtacagagca	EtaKappa
aagtttagaggcctaggttttttctttcgaaagctttctaataaattcattgactttacaatgaaattgataaaaaataaatcgttatttcatcgaaaaaactctaaaaatccacagtactccttaaaggcgcatacccgtttttatttcacaagaacttgtcgcggtgagacctttttgctcaaaaatctttttaaaaa	taaaaatccacagtactccttaaaggcgcatacccgtttttatttcacaagaacttgtcgcggtgagacctttttgctcaaaaatctttttaaaaaaacgaaccatttgatgatttccccagggaaaacgcgtgtttcttcggcgaaagacagaacaagaaattggattttctaatctttttccagaaaacagggcgaca	EtaKappa
attgtagaagtcagaaaaataaatataaattttattaatataaaaaattatcatctcaactatccgtattggtaaaattgccaagttgacacggcaatctgctttttggctgagccttaattttgaaagttttcctgttaaacgtccaaaatacgaaacacgcttcaattgcacatccggcaagttttgtcacaactata	tggctgagccttaattttgaaagttttcctgttaaacgtccaaaatacgaaacacgcttcaattgcacatccggcaagttttgtcacaactatatagggaccaatattctgaaagttatatactttaaaaaaaaagttttgagtagaaaattacctgaaaactaaagaactgcttatgtgcaaattgatttgcaataaaa	EtaKappa
agaagtgaagatggctccatgagtgtacacatgaatcgggtagatctcagagtacttatttgccatatagaacatctcggccttggtcattggaggtttgtactcgcaaagcacctgatgctttccttccaatcgatccataatgatgcttccctgacgaacgtcatacttgtacgctgagtcctggacataaactgccg	aaagcacctgatgctttccttccaatcgatccataatgatgcttccctgacgaacgtcatacttgtacgctgagtcctggacataaactgccgcttctccttctccattggtgaagtaatctttgatatttgggacagtaacccatgcatcgtagatgcccaccatgtcgtttagcagaatgtccaagttgctcgcatag	EtaKappa
atttctgtttcaaaatcttcatgtaaaagtacttacttttcaaacctgctttgcttggaatcgtcactttctgctgttatacttaatttttattgtaagagttaagtattcgttaacttactattagaattgttgaaaaaaaaattagttaagcaaatttataaattcaataacttgtgtaaatttcagaaatctacaga	ttcgttaacttactattagaattgttgaaaaaaaaattagttaagcaaatttataaattcaataacttgtgtaaatttcagaaatctacagaatatacttgatttgaaatttttaacataaaaattattgagtgtcagagccaataaaaataataaggagcatatttgcctagagaattgcctcttaagactgttccctc	EtaKappa
atctgacaacaaattatagtggattttcagataactataagcagcagagtgacacatttcttttgcaatacttagaatacataactttccagatacaagcgtttcgcgttttttggttaaattattctggaaaatcttgaattaataattttttaggaagtaataacataccgtagtaatatcataatcacactttgaat	ttttttggttaaattattctggaaaatcttgaattaataattttttaggaagtaataacataccgtagtaatatcataatcacactttgaatcatttccagaaaactggtcattaattatttttccaaaacactccaccattttgaatgcataaaagtaatgtttctcccatctccaattgtatagttgtttcagtcgtt	EtaKappa
caaagaggtatttcttagtgttctcagattttggcaagaaaggtcaactattttactattttctttaagattcccatcttcccgtttgtgaatcatttttacagtgtgataagaatggttcaaattatttttctttgtatgtgtactgtaataatttttatcattcttgcttatacattacggtatattcaaactccata	aagaatggttcaaattatttttctttgtatgtgtactgtaataatttttatcattcttgcttatacattacggtatattcaaactccataagttcacagaatcaacatgaatttccatttccaggtcaacaagtctagtcatcttgactttggctgtaatgatatttgtggttcttagtggcatctttgttcttatcgga	EtaKappa
ttggaaaaaagaacattcattcaaagagaggaaacatgaaatagataactgtgtcacgggatactttcgaaacaaattcctaacacagctgagtcagaaaattgttcaatttgaatgtgatcatacaatatttactttccatttaaaactgtatactacaatgtaacaattattttttgctgtcaaaaaaatttaaagtt	tgaatgtgatcatacaatatttactttccatttaaaactgtatactacaatgtaacaattattttttgctgtcaaaaaaatttaaagtttctggaaaaatattgtatttttgatgaaaaagtgatctataaaaaatgttacttaatactttattaaacagcgctatatacaaagtctcaaattgcgaaaattcaagttca	EtaKappa
acatcattttatttttgcaatatcccacgcattttctcatttattcccaactcaaaaaaagtcaaacttgctacattttgagaagaaattaggaaaaggagttcttcgaaggaagatgtcctccaaaaatttatgatgttgagtaacatcaaacccacaaaacgcgaaatgcccgcggggctcgttttgtggacattcct	gaagatgtcctccaaaaatttatgatgttgagtaacatcaaacccacaaaacgcgaaatgcccgcggggctcgttttgtggacattccttcaaaaaagtggaaagacagataaaaaacgtccaaaattcagacatcgagtttgatggtgtaaatcgtactttaaattgttctgacttgtgaataaaatgtagttcgttcc	EtaKappa
cattccccccaccgcctgtagtgatggctgctccggcatcggcggctccgcagactccaattcagcagcagcagaagattcagcaggttcagcaaccgaagaaggttgaagtttcggtatgtaccgtggcgaaggcgaagaaggaggcgtggtatcgcctgcaaacctgccgcacggttcttgtgtcgatttacggtgtg	ttcggtatgtaccgtggcgaaggcgaagaaggaggcgtggtatcgcctgcaaacctgccgcacggttcttgtgtcgatttacggtgtgaagctgtgcacgattttagttttgaggatctttgatttttgctacaaaaaacaacgccgcacagaaatagaggcgggacgttattgcgcaaccctgccgcacggatttttcc	EtaKappa
tgcaaactaatttgtgcctctaatgcatataactcacatcactttgttgaatattgcccagaaatattttgtcgttttgatccgtgcataactgataaatccgccaactttcattaaatggcggaatgtaatgtgagaattgaaatgcgaaacatttcgaaatgaacataatccatagacatatcaaaccatagtgcata	attaaatggcggaatgtaatgtgagaattgaaatgcgaaacatttcgaaatgaacataatccatagacatatcaaaccatagtgcataacagtctgaaaacaagtttaaaatagtgagagtggaaacgaaaaaaaatcaggactggcgaataaattgcaattgcattgttccttgttttttttccgatttcttgaaaaaa	EtaKappa
cctggagctcgccagaagctgaacgcactgaacttccagtcaagcctcttttgaataagtctagttgcagactagaagccttaactacctgatgagattttcacccttctctcattagtctatttcattaagcatgaacttacacgagaattccaattacattaccatgtaacattacttaagatcccatttccacttaa	attagtctatttcattaagcatgaacttacacgagaattccaattacattaccatgtaacattacttaagatcccatttccacttaatttgtgaaaatcgatacggttttataagaagtgttttgtccttttgcctatagcctagagcaaaaatacccaaattatttggcagatcatgtctccgacaatattctgatcga	EtaKappa
ggcccgagcgccgagcacctgtcttttttgacctcctttttgcgaatgtaaaaaaattaaaatttagtttgatttttataaaattccaattatgtaatttgtatttaataaaaactccttatatgtataatttttgcacagtttcactaaaattactctcccctcccattatttctcctatacatatactttcccccatg	ctccttatatgtataatttttgcacagtttcactaaaattactctcccctcccattatttctcctatacatatactttcccccatgtctcatttgactaattttattactgtgcaactggatggtcgagcaataaaagttaggtccatatggcatatcgaggtgaggtaccaagttgttttatgagtttgctaatttaat	EtaKappa
ttcgcgcgcatcttgtcacgtgcctcttcactcatttccacgccaaatttcaaagtttccacgtggcagggttactactaaagtggcaagacagtagtatttacgatcgacgcgcttttacaaagtatgtgtgagatggtggtgatcagaggtagtagtgccattgataaaattgcaaattattatcacaaaaatggttg	tttacaaagtatgtgtgagatggtggtgatcagaggtagtagtgccattgataaaattgcaaattattatcacaaaaatggttgttgcgtcgtggcggggcaagaataagataacaaaggggagactctgtcctatacaaaagggaattagaattaaaatgcaaatagaacacgtacttgcagcttcttgaaaactatct	EtaKappa
tgtgggttttaacgaaatactctgactataatttggacaaaatttttcaaaattgccgcctgaaaagccatatgattttaaatttgtttatttaaaacaccataaacacttgagatacaaactcttactttatacaattttaataggtttgatgttttttaaaacaaatcttcgaaactacataatttctatggaaacag	acaaactcttactttatacaattttaataggtttgatgttttttaaaacaaatcttcgaaactacataatttctatggaaacagttgtaacatatcggttcaagattttttttagtgtttaggtattactagggctggcaaatcgaacacttgccggcaacccggtcctgtgaaaactgaagaaaatgaattttaaaaaa	EtaKappa
acaactaatgtatataaaataatttcagggaaacattgaaacaaaacacgacgatccacaattcaactctcgtaacgttgaactcagaactaaattggatctctatgccaatattcttcactgtgtcacaattccaacagtacctaccagacattctgtaagtaaacttaccaatttgtttcagttggagagtttaaaaa	tcactgtgtcacaattccaacagtacctaccagacattctgtaagtaaacttaccaatttgtttcagttggagagtttaaaaaaattgtattcaattgttaaaacttcttatttttaagggaattgatattgttcttatacgtgaaaatacggaaggagaatactctggattagaacatgaagcagttccaggaatcgta	EtaKappa
aaatcggcaaaccggcaaaccggcgaattgccgaaattgaaaatcggcaaacgccagttgaacaagtgaagttcctatcagaaattgcatttaaaaataggcttttccaaatgggcattcaattttttggctgaaaagtgagagggtttctcaaaaactggaagaggtacagaaaatttgtcaactaacaaaatgattat	ttcaattttttggctgaaaagtgagagggtttctcaaaaactggaagaggtacagaaaatttgtcaactaacaaaatgattatcaactatcaactattgtgaaacattttgtcagttaacaattttgctccattaatttaaactttttgagcactaaaacttcctccttaaaacccccttttgctgaaaatgtgccgaat	EtaKappa
atctgaaatcttcactcgcttcgttttttattgatctttcaacggaaatgttaattttaaagtctctagaaaaattcgttttgtttatcaaatttaaaaacttttgaatgttggcattttaatatttctagaataagaataacatcttttcaaaattcctgaaaactcttggagttaaagaatattatcagaatcatttt	ttaatatttctagaataagaataacatcttttcaaaattcctgaaaactcttggagttaaagaatattatcagaatcattttcacaaaaaaatcacaccgctaaacattgacccatgcgtaattacggagtatcgtaccaattctattgaaattcttttttcacaaattttgaaacattttcgatcgattttcccaattt	EtaKappa
ctgaaaaaaagttgtagtttacgtaacaatcacttttagtcgtaccatattatccttttcgtgcagctctccgtgcattaaacgctcattattgtttcctttttgcgatgtcattgtcgacttcattgaagtattctttttcaatgagattgtggactcataatgcatatgtgtatttttcaaatataatgctccttgtc	acttcattgaagtattctttttcaatgagattgtggactcataatgcatatgtgtatttttcaaatataatgctccttgtcttggtggacacgtattttgtggagaatgaggcatccatccactatctccaagataagtcattattgcaacgttcagcatattggccatagcaaaaatttcacaagttgatgcccaaact	EtaKappa
ttctagcacatattttaatactcaatatgacgtccaaaaaaaactggaatattccgctaacattgtgaaaaatttgctcaaaaattcttcaaaatttgaattgccgcaccagttttgggtttttaaaatggtatttttccgcaaaaaagtatttagttttagcaaaattttcatgataattcctccaaaaccgctatacc	tttaaaatggtatttttccgcaaaaaagtatttagttttagcaaaattttcatgataattcctccaaaaccgctataccaaaaaaacgttatcgaaaagcttcccgttaccttgtaaatctgattcaacgtcattctcttatccggcgaagcatcgattgccattgcaataagtgcaacgtaactgtatggcggcttgtc	EtaKappa
aaaagagtttgaaggaaatagcagaaaaaatcgattttttccaagaatttgattattttcatgaaggaattaaatttatcgttaaaataattcaagttttcgaagcttttagagattttctgtggagaaaataagaaaaaataagataaaaaggtcaaaaaaggaaagaaaatcaaagaaaaacaacagtgtgcatattg	tggagaaaataagaaaaaataagataaaaaggtcaaaaaaggaaagaaaatcaaagaaaaacaacagtgtgcatattgacgtcacggtgtttgcagaaactacggtaggccagcacatgctaattgccgcgcaatgttttttgtttttatttaattaattaattaataagttttaaattgaatattcaatgcgaaaacca	EtaKappa
taagaagttttggatcttttgacccctctacgtcattgcctttcatgaagcaatcttcaacgattcccctctctctctctcttttttttcagcggttttcatcttgatataatcaaattttcctcgctcatttttttcccaaaaaattattttccttttggccctccatcctcattcaaaattctttttttagcttcttc	ctcgctcatttttttcccaaaaaattattttccttttggccctccatcctcattcaaaattctttttttagcttcttcccaccctcttggaggactccctactgctcattgctcgtcaaaatgacgttggcggccggcggcggcaaagtattgagccgagtgccgagccagctcaatgcagatcaattatcattctgtta	EtaKappa
attttttagacaaattccgtccactggcgcagcagcactccaccacacttcaaaacttacattccaccgcgtccaggtggtccaccacggaatcctcctccaccgcccattcctcctctcggcgatccacgcattcctcctctaaatccaccgcctccgtaggctccaaaatctccataggctcccgggccaccgtatcc	gatccacgcattcctcctctaaatccaccgcctccgtaggctccaaaatctccataggctcccgggccaccgtatccaccaccgtaacctcctccatatgcaccatatcccatgtcaccaccgtagccacctccccaaggcattggcatgtcgtagccattgttgaagctgaaaatgtgttgatttttcatagtttttca	EtaKappa
tacgagggcagaccataaaacagaaggcgatccttcacattgggggaacacagactgtcctgctgctcttatttacgacagaaaaatactgtgcggagagacacatcgcgcggctatgggtgcagtacgcgcggcaggataaaaagagtggcggaccatcgattggtattgtttgcggatgggttaccagccattcaaac	agtacgcgcggcaggataaaaagagtggcggaccatcgattggtattgtttgcggatgggttaccagccattcaaactcagccctcttgagtaactgctaatccactcttgaaaacctatcatttgttgggagaccaaaaataaagggaacggggaattgctgagcaaaaaacatatctatataaatttgaataattaaa	EtaKappa
gtcattgttcctggtgtggactactaccatgcttcttgggttgatgggcttaagccaagtatgaatatcatttattattttgaaattaattttgaaaattcagatcaatacattcttgctcaagctccacgtgatgccagcgcagccaaggacttttttaaacttttggagcacgtgaaggctgaaggtcttattgttgc	tccacgtgatgccagcgcagccaaggacttttttaaacttttggagcacgtgaaggctgaaggtcttattgttgctgaaggagcggacgagttttcaaggtacgagctttgattcatagcaattgatcttattcagagaattaagttatttcaaaagtacattttcagtgcaataacggcaaaatttgaaaaaggaacag	EtaKappa
cggagaaaaaagctatcaaaaagtttttaattatcaaaatgtagaaaatgttacggactatatttcgccagttaaaagttttttaatagcttttctccctgcagagatacaagcgcttaaagtttacggggtaaaagagtgtggtaggggagagacgcaggcggcgcgcgcacactgcgtctcctctccccccacactct	acggggtaaaagagtgtggtaggggagagacgcaggcggcgcgcgcacactgcgtctcctctccccccacactctatcaccacttttactttaaacgcgcgtatctctgtggggaaggaagctatcgaaacatttccaactaacaaaatgtagcaaattttaaggactaccagaaaattacacttaccttatgataaccc	EtaKappa
gcccaaaaaaaaattcaattaatttccaagaatttgtgctattcgaacgaaagaaattcgagaaattcgagatgacttgagggtctaacaggaaaacggaagttgcattgaaattcgacctttttcttgattttttggaatgtctaggaaggaaatctcaactatattgaggtttggagtcatagaaaaactgaaattct	tgattttttggaatgtctaggaaggaaatctcaactatattgaggtttggagtcatagaaaaactgaaattctctcaccaggagtcgaacccatgaggttagatccatagcccagcctcttaccgggtaggccatgcgcaagggggaggatggcgctgccggtaagaggcttgcactctgagcaaaatttccgtgaaagc	EtaKappa
aggtatctatcatatcacagacgtttaaagtttttattcaattttcaggaattacaaatgttttgatgaaaggagaagctcaatggcaaaacggcacgttcgattatgacacatttagtagcggaattcagcattactgccttctctatttcctgttgggagtcttgatgtttacgtgtacatatttttcggtgagttag	tcagcattactgccttctctatttcctgttgggagtcttgatgtttacgtgtacatatttttcggtgagttaggatatttttttggtaattgtgtaactgaggtaccacaaaataatgttttcatttttaacttaaactttgattatttttgcatttggaatacttgagctaatagctaaacattctttgctaaaaatta	EtaKappa
gaggtttttaaaatgacatatgtttcatttagtccaaataatcagcattagaaaaacaaaaaataggtacttacctgacatgctgttgtgaagcatgcggtatgttcggtcattatgctgtggaaggctggagatcaggttaagatgagatcggtaagaacctgaaaccatagcttaagacttttgtgtatacgtaccaa	ctggagatcaggttaagatgagatcggtaagaacctgaaaccatagcttaagacttttgtgtatacgtaccaattagtgaatccagacaagctaactatataggctcctagactaatttttgaatgcccaataactttggaaagtgaaaaaattttaatagaaaacttaacttgataccgctctaacaatgaaaaagata	EtaKappa
actgatcccttggtaaaacggaaaacaagaaatttttctcaatttatgatcggtttgtgaaacgaaaaacgcacgaaaatgattggtgatgttgcgtaaatcattcgctttaaaaatatgaaccccgaaattttctgacaccaccttcatcgccacctagtcacacattcacacacagtcgccaattgatgaatggggtt	aattttctgacaccaccttcatcgccacctagtcacacattcacacacagtcgccaattgatgaatggggtttttcggtttttatttgatgctgcggctctggtatcccatagatggataatcttctgaatatgtttggtgtcgaagatgtcggcagtaatcttgacagaggtcacttcgtagtctgagaaaacttactt	EtaKappa
tcttggaaaatttaaatttcccgccaatatttcccttaaaaaattaaactcccgccaaaattttctcagacaatttgaattcccgccgaattttttcctaaaaattgaattttccgccaaaaatttcctagaaaaattgagcttcccgccagaatttttcttagaatatttgaatttccagcaaaaaatgttctcagaaa	gaaaaattgagcttcccgccagaatttttcttagaatatttgaatttccagcaaaaaatgttctcagaaaatttgaattttccgccaaaaattttctcagaaagtttgaatttcccgccaaaaatttcctaaaaatttgaatttccgccgattttttcacagaatatttgaatttcccaccaaaaatttcctaaaaagtt	EtaKappa
ggctggaatgatcgatgccaacttggttctcaatcagttaacctgcaacggagtgttggaaggaattcgtatttgcagaaagggattccccaacagaatgcctttcttggatttcaaacaaagatacgctgtcttagctgctgatgctgcgaaagctggaaaggatcctaaggatgctggagagaaaatctctgcagctc	ttagctgctgatgctgcgaaagctggaaaggatcctaaggatgctggagagaaaatctctgcagctctcatcaaggacggaagcttgaaacaagaggaattccagtgtggcctcaccaaggtcttcttcaaagctggagttcttgctcatctcgaagaacttcgtgatgaagcccttggaaagatcatggctaagttcca	EtaKappa
agaattgaaaatggagtagagtcattttggagttttttttatattgatagaaaatggaccgtaatgaccgaatgtaacagttaaaaaaaaacaaataatttcctaattttatttgattttcagaaaattgataaaatctcagtttttgcctaatcaaatttgactttaccgccaaaaattagataataaatttaaaaaaa	aatctcagtttttgcctaatcaaatttgactttaccgccaaaaattagataataaatttaaaaaaaacaagaaaataatcaatgaaaaaactatagtctatgtattagtctaagtatagtctatgtattttggaaatgtccgtgtttattcctgttttttttcacttaaaaactgatcaattagaaaacaattagaaaca	EtaKappa
gacgatttctgtgcagatatcggagctacacgaagctctcacggcactgaaaccctattcgctcgacagaaatttgtgacttgctgtaaagcattccaacttcaagcaatcgacagtgtctacatagatatcaaggatcttgacggtctccgtcgtcagtctgcagaagggtggcagtggggtttcactggaaaacaagt	gatcttgacggtctccgtcgtcagtctgcagaagggtggcagtggggtttcactggaaaacaagtcattcatccaagtcaagtgtctgtggtccaggagcaatttctgcctccgaaggatcgaatcgaatgggctcaggagctggtccacgcttacagtgagcacgaggcattaggaaaaggagctttccagtttagagg	EtaKappa
gtctgatagtcataattgcaatcattaatattaactggtttgatgtgttcgcttttgtttcctcaaatattctgaatatacctaaccctctaattttctaattaaaaaaatacaacccaacgtcagagaagttgaattgacattgttaaaaaccaagaaccataacaaaaaccattaacaaagtggtggccacttgacag	attgacattgttaaaaaccaagaaccataacaaaaaccattaacaaagtggtggccacttgacagaaggaacaaaatggtggtgtgaaagtctctggctgaaggacagaatattacggggttcacattttcaatactcaaggatagacaacagcgtttatcggaacagtgaaaggatgctgattattgggtggatttaga	EtaKappa
gtcaaccacacttttcattcttcgaataacttccaacatgtctgtttatggacatataccaattgataataagactgaatattccaattttacatattcattcaatgtttggactgttttcgcagcagtcacttgtacatatacactgttttcgttttggattacactaaaaatgtgcattttttatttgaacaataaaa	atatacactgttttcgttttggattacactaaaaatgtgcattttttatttgaacaataaaaataacgaagaagtgaaaagaggacttcgtcttgatgtttttcgattgtttcttttgatgcaagtatggaaagaatttcatgttttgatggattttctgatagttcgaattccacttacatcattatttaccagttatt	EtaKappa
gcttggacataaactccttggttgaatgatttctcaggagaactttgaagtattcagaacgtgctgccaggatgcacatatgagttgggaattcacgaccacacgaagcgactataatgaagtcgctaaattctccggtggatagaaactctgtgaatgcatctgaaagtgattaaacaatgaaaatttccaagctgtta	tggatagaaactctgtgaatgcatctgaaagtgattaaacaatgaaaatttccaagctgttaaaatcactaaccatgcgcagacgattcgtcgatcttcaaacattttgtattgggagacgatagggatcgagatgttgaagaagcgctgtgagttctttgatatggcttgaacaggcttgagatctgtgtcgtacattc	EtaKappa
tggaactcaccgtttccgtttttgattaagttgaagttcatcatttcctcctgggcgtccggatggtcaaccatgtcgaagagctgaaaatcaatgattttatgtttctggcacacctgatttgaattaaaacatatgaaaattgtacatttagtttatttaaaaagagagtataacctgtttggaataattaaacctta	aaattgtacatttagtttatttaaaaagagagtataacctgtttggaataattaaaccttatttctatgctgatgtaaaaatgactaaatatcgtaataaaaattgtgtggcacattattattttaagtcaaaaagccgtaaaaacacattttgcacctattttttatatccaaattcgaaacaaattgttccatagttt	EtaKappa
tcaaaacattttctgtttttaaatcctctaattaaaccacatttttttgtgctgccctccatgaaatccctcaattttgtgtccaagtgtaattcattaacaagccagcaaatccatccacttgttcacacggaacaagtgagagcaagagctgataacaggcaaagatgcaatgacaaatgcgagggcctctcctatgt	agagcaagagctgataacaggcaaagatgcaatgacaaatgcgagggcctctcctatgtaattggttgaaggctcatttgtcacccatcatttactttgtggtcgggtggtgccgattcgacatagagacctcattgacttgtttgtcatccggaaaacattcaaaacaccataactccctacacctcgccccatcccct	EtaKappa
gaaaatctgcaaattttatggttaatagtgaggttggaaaatttcttttgaaacacaaaatatcgatttttcagaaagttctagaacaaatcgattttctacgtggcacaacgtgcgccgacgagtcgctatgggcaactattgctgggaatcctaagggtacccctaatatttatcaaaactttttttttcagttatta	tgctgggaatcctaagggtacccctaatatttatcaaaactttttttttcagttattaaattttcagagctcccaatgcctggaggttttgatgctaaagcttggatccacaaaaattaccgccggacacgtgggaaactgggaaaatacggagaaaatcaaaaaatcgataatgggtactatgtgtcgaggtaccaaca	EtaKappa
cttgctaaatctcatgataaatacccatgagctcataaacaaccatttcaattgaaatgtttccactttttagccttcatgagcttcataaactctatctgctccttctaaagtctataatctagttttcggactttcaaacaaatagtcataagctgttccctcctcttactgctcacaacaacgttgtctacgttgaa	atagtcataagctgttccctcctcttactgctcacaacaacgttgtctacgttgaagatgacataacgtcacgcatcacaaatcactctgaagctgatcggatatttttgggtggccagtccgggttattttcaatttgttttcatctgttctatgttttccactctttttttccatgcctattgtcaagatgtttggag	EtaKappa
tcattgtgaacaccgtcggaaactgtagccatctggaatcggggcatttattgaaaatggctgaaaaccaactcaccacgtcagaatacataattttcaatgaaacaggaaacatttttgtctgaaaaattgaaatagtattgtcgatgctaaaaatcaaaatgcgaagccataaaaagaggaggggaagtaaataaata	ctaaaaatcaaaatgcgaagccataaaaagaggaggggaagtaaataaataaactggtggaggagagaaaggttttgaaatatttcaatggagcacgtttgcagattgcaaagggagacacagtttattgatgaatttgtaaatgttcaagagtctaaaatgaagaaaagcccggtggaaatgtagagaatgaatatagg	EtaKappa
aaacataaaatcctagtttttcgaaacttcaaaccgagaaacctcatagctaaattagtttatttttgcacaatttgttcgacatatttatgaattattctgctcattaaaaggtaaaaaagtattttttaatattttggaaaaccgagtttttaattttaaaaaatgcgtacttttctaacaaagcaggtttatcgtca	ttttaattttaaaaaatgcgtacttttctaacaaagcaggtttatcgtcatcatcactatccacagaaatctctttccgtttcctttttcgttcagcttcaacctcagcctctcgttttcttcgtttcgaagcagcctcctctgcttttcgatttctttcttccagctctttctgtctttgtttttcttttttcgccttc	EtaKappa
aaagctctgtctttgaaaatctctagtttcatttttcaatcatgtctattgaataataaatatctttcctctcattcacttttcttacccactgacccactttctcttgtgactctcgacagtgaaacaccgtacctaattaggcaatttaccagtagttcatattcattctcgggagtacgcaataccacacgctcatt	ccagtagttcatattcattctcgggagtacgcaataccacacgctcattgaactttgagaaaggcgatttgaaatcgaaatttatatgttttcaaactattttcttcatgaagtatggtacttaatatatatgtcttgatattgctactttatggtttgagtgagtttttaaaaagttttggatttgaaatctttttttc	EtaKappa
cgaacggaaggtacaagtccaaagaattgagtttcgctttcgtttcatcttactcttcagtcacgtgaactatctctgcgcggtcacgaaattcagatttgcaacgtcgagtcgtaacatgttacacaaattgttttcataatgagatgtacgtatgcatgcctgcatcttcttcatagtcagttcgtcgtcttcttctc	catgcctgcatcttcttcatagtcagttcgtcgtcttcttctcaagtagtcaatgcaaaaatgcagaagaagccttcggatgagtatttgagaagaaggcgcaaaatagcgtgaaacagccgtcggcatcatacaatcgtaagtgggaggagacctcctccctcccaccggacggcgcacgcaacagcccgtagacagaa	EtaKappa
aaaattttcttggaaaatttaaatttcccgccaatatttcccttaaaaaattaaactcccgccaaaattttctcagacaatttgaattcccgccgaattttttcctaaaaattgaattttccgccaaaaatttcctagaaaaattgagcttcccgccagaatttttcttagaatatttgaatttccagcaaaaaatgttc	tttttcttagaatatttgaatttccagcaaaaaatgttctcagaaaatttgaattttccgccaaaaattttctcagaaagtttgaatttcccgccaaaaatttcctaaaaatttgaatttccgccgattttttcacagaatatttgaatttcccaccaaaaatttcctaaaaagtttgaatacccagccgattcttttca	EtaKappa
cccatagtgggcgagcgattcccgagtgaaaataatcacggaatcttatttttttttgactaaagattattttgactaaagattgtaatttgtaactaaatttacaagttccaccgaaaatcgagattttttataaaaatgtgttctttttaagcgaaaaagtttttaaaaagatttcgcgatttttgaaatttgttcga	ttttaaaaagatttcgcgatttttgaaatttgttcgaaaaatttttaaaataaaatttgtgcgatttttcgaagaaaatttttcatttttagcgatttttttggatttattaaagaatttttcgctgaaaaacgaacctttctcttctgactctttttcatcaatttttcccgaatcgacgaaattgacgattcatcttt	EtaKappa
ttgtctttgttttcgaaaccaatggtaaaacacgatgtttttaaaagcattaaatttctgatttgtttagtatgtagatgacagatttttaataactaaatttttaatacggtatgaaatgttatcaaccctcggaatttgagggaaactttctgccaaactttgtttgtctatatctgcctgtaaacgttgtggctttt	tttgtctatatctgcctgtaaacgttgtggcttttttgccagaatcttgccgactgatttgaggacattttactaagttaccgtgttgttggcagaaagttgtcccacatacaagaatcgaaatttgtatcgtttgccttttaagactttcgaagtaagcgttatttttgaaattttccttttttcaattttacttttaa	EtaKappa
tgtttggttgtaggcacgtgtgtaggcataggcagaccgcctaggtaaccaaattaaaaataaacaagcaactgaaccagtactacaattttgccagtttcaaaattaaaaaatatatgtatcttcagatatggtggcttcatgaatttgtacctaatcagcacaattaatacattttttgctgttatgaaagaatatga	ttaatacattttttgctgttatgaaagaatatgaaaaagaggtaagctaataattttttaattccatcaatttttcttattttagggttacatgaaagttcaaccatggccaaaagtgaatttcccaggagttccaatggatattgcagatacacacggacaaattgaatttagaagtcaaacagcagcacaaactgatt	EtaKappa
ttcttattacaaattgaatatataacattggcgatcaggacgttcgagagcttacaatggccgaaggtaagcctactgctttatcagctttagaagcgcttactgcgcaagttgccgctcaagagcagcgctctcaacaacagtttgaggcgcaagcagactgacagagcaacttattaatagattgcttgcccagccag	agcaacttattaatagattgcttgcccagccagaactgccgcgccagcatgccggtggggacgtggttgcggcaccacaaagtaatgcccgtcttatgaatgatttgaagcgttccatccaaaagttccagttcaacgtcgccgagcctgaggctttcaagagataagctcacattcgtggaagatggcaaaaacttgtc	EtaKappa
gagtcactaattttggtgaacggccagagtcactattttctttttttttctccaattttttaagttttataatttaaaacaaatttgactcctaacttttcaaatttctatagttttattgaagagcttgttattgtgcatcgaatgtgttatgaattgttgcaaaatcttcgtttttcgtctttatagagtattctgaa	tcttcgtttttcgtctttatagagtattctgaaaatgctctcattatgtccacactccaatttttagttttatattttaaaaaatttgactcctaacttccaaatttccgtagttttattgaagagcttgttattgtgcatcgaacgtacttcatcgatgtacaatgttcccatgctctgcaaagttcctcctcaatttc	EtaKappa
aattcaatgaccccttcgctacattggaaagctggtaatacacccataacttctttatttttattccaataatatgattttgaaaaactattaatcttacctgtgcatcaataaagatcttgtgagtatatcatcgatcacagtctccgatttgtctgaaataaccgattccgtcttatgagagtccaaaagtaccgaag	tcttatgagagtccaaaagtaccgaagagagttttccatttgacatgagacatgttactattcccttattcagtgacaagggaacataggcgtgaggtaggcgtgtcgcgctaacgtagatcacagattctccttgaatatgctgtttgctcagaagaaacacgtaaatattctgagagtcaaatacggcaaaggtgttt	EtaKappa
ctaaacacactcctaccttattcttcatctccctgaacattttatccaagttgtgatactctgcagtagccttctcgatgaaagctttcgccaccagcgcgaatcgatcgttctccggcggaatgtgctcggggagctcaacttttgtggtggactctaacaggttcagctctttcctcacaatgagcagcgcctcttca	tcctcacaatgagcagcgcctcttcaagattccgaatttcagctgcagtttcagactggctaaaccgggcggcctctgttacggtggcgaagtccttcttgaattttgtgaggtctgggtacttcttttcaatgaaattcaccaaaaagtgaaggagatttctatcatttcgcagtgcatttttgacatctgccagttta	EtaKappa
caaacctctccaatttgcgacaattccatggcttcgctgctttgtatcctctaataatcaaatgacagtacttcaaaagtcctccaccacgaatttcttccggtttgacagtatcgattaatctctcatgaagatgagtcattgcttgttgaacatcaccgtacatgctctcaattgtgatctttttctgttcacactcg	tgatctttttctgttcacactcgtccaactcattaagaagtggatccaaatgaatttggaatgaatcaaccgagaattcaaattgccgcctcattttgttcacaaacttcagctcaatgcaccgtccgtactcgttgttcagtgaaaacaacgaccatttatcattgtcagtggaaacctgaattaatttatagttatta	EtaKappa
gctggttgtgttgaagaaatttataaattaaatatatttccagaccgacagcaatgtgaacgcgatgatgtggctgatcgtgttctgcgtcgtcttaatccttctcgtgattctccagtgcgtctacatcttttggctccgatcgtcctttgtctcggctgacgaggcctctcatcatcaggatcaggagactgaagcct	gatcaggagactgaagcctccatcttcatcgcgaaacagcgcagcttcccagcgagtttccatgagccaggacttttggatgtctccgtcgacaagtggaattaaatcatttttatttgaatttatagcattctcgttctttttcaatcttttctagccttctatccttctagacactagacactgtcatattctcatct	EtaKappa
atgaatttcgtcgaatcaccgacctggaaatttcaatttaattttcgcttttaaatggttcaaaaaaccaaaaacgcgatgtaaaaaagtgaaaatttagctaaaaattgagtttctggtttaaaatacagctaaatttagggaaaatattgaatatacacggtggtggttcagttgctagatgggtgcaaacgcgctcc	tgcaaacgcgctccaccgaacaaacgtgcataacttggccaggaagtacaaaatcgaaaattcatcacaataataaagatagataatttcattgcgcggtcatttcttatatgcatcgcaaaatcgattttgagtatcatgaaccaatccatcgttttttgcagaactaggccattttgactcgtagatttacggcgcgt	EtaKappa
aacaagaaaaatagacagcaatggcgtattttatagtgaaccctggccatttgaaggaggaaaaagaatcaacgaatggatatgtccttcaatagttttgcccttcttccgaacaccaattggagatttaaaacttagatatttttgaagaatggatgaattgaaagtgaaatttgtctattccaggttagacatgaatg	agacatgaatgagcttattatgcttagtcattgccaggtcatgagaagttttgaaaatataaatactgaaccttttctctgtaaatgtggacaagaaccccaaaatggctaattcagcaatcatttcaattcccgtgcagttgtgtaaactaatcattcagtttccttaccattttatcagctttaaaaacccaactcac	EtaKappa
aaagcttatgaaagtttagaacaaatttaactggatacaacaatctcaacagtatacacgagacagggaaaattgcaattttgatcatttcaaaatatttaaatttaaaaaaaaccagttattgccaaaacttgttaaaatgtagattctagcatttacaaaaaattaccgtacaccatatctttaactttaacagtgtg	agtgtgttgccacttttttgagctcaaattatttaaatgccgaaatattaggtatttttataaaaaataatttaaagaatcctaaaaaactaattatgtcaaattatggtttgatttaaattttgatcgtaatagctttataagtactgaactttccagcaatcggaaatttcagcacttgcaaaaatttcagattgtcg	EtaKappa
tagagaaaatctatcgaaaaaactctgtttttaagagcttaagtttctcatttaattgttttaacatttaatagttgacgcttgcaaatctaaaaatcaaattattaaaatccgagttgttgtatagcatgttgtataacaaagacttcactttgaatttcaaatctcaggtcttatgtcccatgagatttttgaaacac	ttcggaaaacatgaaaagcgaaatggaagcatttatgtttttgttcctttcgtttttgcagatgcacttctcccattgaaactttttactgcaatcgaacatcttttgtgttttgatcactttttattcacccaaaaatcatttctgtttaattactttttgagctaggaattcaaaaattttaaaacattttctaaagt	EtaKappa
attgccaatttattatgagcgttaaatttgcttcagttctaaatgtttttttcgaaaactcactgaacatcatcgaaataggttatattaattttcgtgggagcagtatcaaattgaaccattcccaatttggaatatttgtttctattaacagttaaagtttgaacaactacattcttcatttgattaaaagataagat	cagcataggcgaataaaaatgttgaacttttcattgcaatggtgcaattctcattgtatttttctgaaaaaaaaacaatttgggagattttcaaaatgatgagccaaatattttagttgtattttaatttgagtgtaagtgcttctggtatgtgcctgaaaaggttagattattttgaatatcagagatcaagaaatggt	EtaKappa
tctatgtgcacggcgtgcttcttatccatgatcccgaagtcagtgccgcctaggtgcaagagagcagaataaatttatttttgagttgtctcttttctatctcaccccatccattccattctaaccattttcgccgaagcttcatctcatttttaagcgcatctttagattcaccgcgtttttgactgcttctgtttgta	tctttgtccaatctgtctttctccttcctccattcgccttccgccccattctcattcaatattttttgttccgctctggcttatccctgttttcatgagccccatcagacttgtatttgtcgacgactccttccagcaccgccccattattgagtaggaccgcgcttcgtccatttttgtctttcctcctaccaccacac	EtaKappa
accgtaaccaaattcgcccgattgaaaccgaatttatttgtttttttttctgaattttgttctaaaaaaatttgctgtttgtttccccttattccaaacattaaagtttcgtaacattatttgaagtaggctcattgtcactccacaaactcgaaaggcatgaaagttacagaacgagcagactacaatgtagtctttga	gagaggcaaaatcgaggcaaaacgagaacgaggccgtgtcctttttcctagcaagactattattccacatacattcccatctctaggcgcctagcgccctccttccatctcatagctatttctctcctgagctctccgagccctcccaatttcggcgccttcctttccccaattttcttgatttttcattatatattttt	EtaKappa
tcgtccatcgactttaaaataccaaaatcgagttgaaaacacaagataacaatgtaaattttatactcaaaatttgacggtgatttcaaaaaaaaatagtttccatccgcttgacaagtgggtcaaattttaaattttaactaattttaggccattttttgagccgttataacttttttttttttttgagaagttttcaa	ttttcagacaattttgagtttaataaagcatttaaaaatcggtagttttcctcatatggaacatgtattttctttaatttcaaccggaaaaatagttatgaaggcattttttcccgcgaaaaatgtttttcaaagttaaaattttcgattttttgcaataaaaatgtctgaaaatttgacaagttatgtttcgctaaaaa	EtaKappa
caattgtgatataatcaaataggggatcgattccctccaattgacgtggtggttgtggttctttgaatggtacaacctgcaagtaaaattgtaatttcaagattcaaactaacattttttacccttctcataaacttgcggccagtttctcggtcagtatcagaaatcattggagaatcccactctagaaatttagtgaa	ttaaattgctgcaatacaccagccgttagtaaaggttccaagtattctgatccataatgcggcacaacatttccatgttctctttgatgacacatatcgcggtaggcaatgatccggcggtagatttcatggaaaaattcattacacacacgtgaattctctgtcgattcaattgctaaaccaaggtccggacaagagtt	EtaKappa
aaaaaaagttaaataatacagggtccatggaaattacacaaaaatgacaagtaagaaaaggaattctacaaaattcaaaatggtaggctctaggactccaggaccacatgcttctactgcggccgatcacgtgcccttctcgctcacgagtctatcgtatcttctcttcgttttctgaattgcagtgacttgattctgga	ttcgttttcctcgtcttcttcttcgtgcttctgctgcttcgtcattttcccttcccctgctaacaatagaagacggcgaagaagggtctagtgaatctacggaccccttgccctccgccacaagcccgggcagctctccactcttcgaaggcacgggaattttatgcgtttagggggtccgttgtgcccaatttgttcga	EtaKappa
cttgtcacgaaaacacagttcattcaaaatccgctgaagtattttaattggcatatccgacaagtttttgggctccagtctggaattcattttttactttaaacataaatattttccgatatttaacctacttctgatcataattcaaatcatgatttccttcataaaatcgataaaaccagaactcaaaatctatgtaa	gagaatgcatgatcgaatgaaaattggattttccagtactgattcggccatttctaaacgaataaaaacaaaatatgagtctgcctaaaaaaaaaaaacgaagacaacaaaaaagtgcaacagcactctcgaagaaaaaagaatacgcaaatacgcagtggctattcttgttgggaggtcttatggagaagcacgaggga	EtaKappa
ctgaccaagtttgtggaaaatttttcggaaaacgtcaaaagtttccaattttcgaaaaatgtcagccaactgatatcatattcgagttctccacgtcactagctttaaaataaccccccaccatgtccatattccattgattttgatttttttgggtcccgtcacgggttactgtagcaccgatttcagctgtgtcgatt	taaacaaattttaagaaaaaaaaatatatatttgccaaaacatttttcaattttcagaaatttaaaaaatcagaattctttctgaaatcttcacgttaccagctttcaaatgacccccatcatgcccatattccgcctactttgagaattttgggtcccgccacgcgggttactgtagcaccgatttcagctgtgtcggt	EtaKappa
tgctgtcgtcacaagatatggtggcaggttttcgcttaaaaacatgtttggcagtttgacttacaagaattttgtaaggcagttgcagaatgttaccttatgtaatgtaaatctaaattttcagagggaggctggaaaaagtgtagtcgatccgctgcgtgtcaactacacatctttacatttcccatcgcacgtgcctg	cacacaggggtgcttgatcaactgaccaacttgatgcaaaaattggcaaactcgaaaattttctgcaactaagttgcttaagaaatatatacttctgctgcatctctattttggaaggttttgcgaaaaatacagtaactttttgatttccggtgaaatcttttttcttttaggttgtctgaatgcgttttccagaccaa	EtaKappa
catcctcctccattttgatggtggttctgtggcatcgggtagccgtgaggagtgatggggcgtgcattttcctgtggttgtggagcataatgctgatgatgttcttgtgatccagtcggagcattaaaaaagtatccaggcggaataactggtggtggctgactgaaattggctggaatcggaaagtccaacggcagtgc	gtgttccgtacgactgatgcttttcgttagctttcttatatttcagatactcgtcaaactcgtctcgcgtcgcgcctacaatgaaaatgtttcggcagcggtgggcttctatcgtcttcatacgatcttgtcggagttgtcgcatattctccacagttcctcgacatactatgccagtggatggagctctgtgctctact	EtaKappa
aggttactctccttcaaacccttcaaatctgtcaaataacgatcattttcaaggatgataacagatggatcaatcttcgatagcttctcctgatctgatacaaacgtgcgcagctgtttctcaacttcaccaacattcttgtctaattttagatcattaatcccttcaacaattttggataacttgtcagtattgattgc	gatttgaactcttctgaaaaatatccagttgcattaatattattattgcttataccatcttcgccaagattcggaacaaatggagcaccgtgtatagtattccaaagtatcaatgatactattggaattaattctgaaaataagaaaataagaaaataagaaactgatatcgttcttgaagattctcgaagagttacaaa	EtaKappa
caaaaagagcacatccaaagccacaaaaaagttgctcttcgtttttttttgaagtcatctattttgtttttcttttttttttaattttcagcagatattatttgtattaggaaaagtctagtttatattttaaagctgcacagttatccaaatttggcgaaaattagtgacgtttataaaattttttgcaaattatagga	tataaattttgaattagttccctaccacatttattggattaaaaaatcgtagaaaagtttttattttggtttatctgtagaacttgaaatagtatacgattagtgaaaaaagataaaaacactacttgaatttcgttcgtttttttctaacagggattgttctgtcagtattcatgagataaatatagtttttttcaatc	EtaKappa
attctgggggcgtgttcctcagcttttcctcattattttcattcttattcgaaatctaaattgaaccgttgcaatgccaaccggcaagtctgaatcttctgatatttctgaagttgttggtaacatggaaatatctaaagttgaggtatgtgactgatttgttaaggttatcaaattctatatatttaatcctagtctta	aaaacattctaggtatttttgaccgatttaaaagatatgttggtcttctggaaaatatagagaaattataatttcctaaccataccgctttacatttaaaaagtatcctaattactttgcattagtacaattctaaatgctcccctattatattgacacagcctaggattggtacatttatacattttccgtaaaatgaa	EtaKappa
gtcaagcactcatcatttccgtggaacaacctcagtacgtcatttccgaagaggaaacctaaagtttcaaagtttaaaaaaatctcattgtcagtgttaactaacccatattccttgttctcatgcttccagaactgactgactggatattccatagtgtttggtgaaatgaggcaatcaccatgtagcctttactgtag	ataaaaaatacttaccaaatatctttctgttgcaactgagaccaaaatgacgtcatcaccgacgcgcaccttttctccttctgatctttgtttggatgctggatgaattgtccaccaacatgcttctcctaaaaattatttttcaaaacttttgccttaaaagttgtaccaaccttcattagtttcttgaactcctacat	EtaKappa
tgattttaacctaaacacgcgaaaactgaaatctcaaaaaacacgaagagatatactttcaaaatgaaacagagaatttttgaaataattttttttgaagaaaagctcaaggaaatattagagaatgtgtacaataaaaatgtttaacgaaaaactgaaaattatatttcaaattttacaaaattatatcaccatgatta	aatttgattacgaacaactatacttttaaattgaaacagaaaaaaaataatttaaaacacgtttttgtttttttgagtggcattttagtttgtgtggttaaatatggatttttaccatagaaatagtttttggcacttttcaatgtttttgttctaaaaaaaaccagtaattaaataacatcactaatatgctcattttc	EtaKappa
tcgtcggtgctcctcgtcgacgacgacggcgtcttccatcctgatgtgcagaatcaattaacaatgaaaactacacgtaaaaagtaagaaaaaggaggcgaactgttaggtgatgacactgggggcagaaacacaatcgagatgagaaagacgatacaatatcaataattcaaaatattcttcgtttttcttcttttctc	ttacttttcgactatttttagctgtgataatttttgggttttcacttctgcttcagactgtatggctggttaattttttttgagttttcagaattaaaaaaaaacatgctcttttttaaatttacattttgacatcaaattgttgtttatatgtgttttaattctgaggggcaattttccggcaagttggcacattgccg	EtaKappa
gaagtgtgtagggttacatcgaatggaacacgaacttatggagttttggatggtgttgatttgggaagtgcttcgtcgacgttggatccgactgctaagcatttgttggcgattaaggaattccatgtgagacggagatcgaagatcaaaagttgcaaaaaaaaattaaaatttttcgcccaaaaaaaatgtattttgaa	tttttttgagccaaagaaaaaattgttcttcagaaattttatgttttagttggtaaaaaattgaatttttttttggttttttttttttgagaaatttttgatccaaattttgatccaaatttaaaggtggagtagagtttgtgggtattttgcttaaatagactaaaactggtccaaaaccaccgaatttcataatgaga	EtaKappa
tcctgttccaagctggagctagacgacgatgatggagtggacgtcatatctgaaattataattaatcatgaaacggaagaaaatagaaaacatatagaatcaaaattcatagtttcaaattactgtttcacaaaaataagaagattaaaaaaataaaataatacaaaaaccaaaacttgtaaatataagctttgttatca	tttttgatttattgaaagaacatgaggatgagggtgacagcaaagatcatgaaattataatacacgtgggaaaagggaatgaagataaaattgcagaagggccttggaaaaatcgttgaaacaagttgtcgccataggatgatgttaaaaaattgaaaaagaggacacttgaaatcagaatgttagaacgttcagaataa	EtaKappa
aggcttaggcttaggctaggcttaggctcagattcaggcttaggcttaggcttaggcttaggcttggaattaggcttggcgtcagtggcgagcgtgagctcgccactgacgctatttaagcttgggtttatagcgtttttttaatttttcaaagggttcccgtctgccgatcaaagcgaaatttaacagagagtcgtata	tttgtttccaaaatattttaaaaaaaagatttagcggctctgactaaattgtttgttcgttttttctggacccttttttcccctttttttgggtgaaaaattttgtaaaaaatttgaccgaggtgtagagttgaattcatcaatttttgacattttttgagtacgggcacatgaaaacgaaatttccaaaaacgcttatt	EtaKappa
tgtccattaacctgtctttctctaccaccctcctggtctctcacactatttctttggcctagattgttcgaagaagtcgtcttcgtcgctgctgctgctgcagctgcttccattttctgatacattactctccgtcggcttctgaaatattcttctttctttaaaaatgggcccactcgcattcataattttatgtcaat	ctgaattgaaatttccgacaaattggcaaattgcctgaattgaaatttccggaaaatcggcaaattgcctgaatttaaaattccggcaaatcggcagaatgcctgaattgaaacttgcggcaaatttcctcacttgaaatttccggcaaattgactaattgcctgaaattaaaattccgacaaatcggcaaattgccaaa	EtaKappa
atcaaatggtgaaattgtgagtgcacgagaaatgcgcaaagggcatcgaaaaaagcgccaaggcaacgaaattagagtaacatttttaaaactgagtttaaatttgaaaactccaagttgaaaattgagtgagttagggatgcatcgagaaatgtgccagagcacgagaaatgcgccaaggtaccaaaaatgcgcaatag	tcaaactcgcatagatacagcaatatccagaatcgcgtcaaggcactgaaaatgcgccagtgcaccaaaaaagcgccatagtcgatattatacttttttgaaagctctcaaaacgctgaattcgaaaatttaactgtcaatgcaaaatatttgaaatttcagccttgaatcccaaaaaattgatggtcactgccgccaac	EtaKappa
aagatgtgaaaatctccaaccgtttagtatgtttattttatgcctagggatatcactttaatgtgaaagaatgcagaaccttgctgcaaaactgaaatttgaaaatgatgtcttttaaggcggttctagttccaaaatttgaagacctatatttccaatttatctggggaccacattcaagcttgattttagagcgtgat	cttaaagttaagacgagtagtaatttttcttactcttccctattttcatcccttttttcaaatctttctcactcttggaatcaagtacaagtacaactacgaaaatggagtcatctctacaaagaaagagttctttaatacactgaatttgtaatggaagacaaaaaggaagaagtttagtaggaatgtgattgatgaga	EtaKappa
agacccgaaacaaggaactcgattgtttgtaccaaaagcgcttcgaaaaggtaagatttatctttcttattaaagcacctttttactaaaatgttattttccagaagccgatgatctccctgcaaacgggctactaagcccgcagagtgtagaaaccaaagagaaaattgcggcggcgaaatccaacggagatgttttca	ggccgctgctgcagctgtggtcgctgcacagcaacaaagaatatggaacggtggagcggctcattttgatattaactcacttgccggtactccaccagcaaactatagttccaatggatcctatggattctttaataatggctccaacgccaatgagcaccgagctccgtttggcgggcttccaaacggaatgttaaatg	EtaKappa
aggtttactactacaacaactaccaagaaagaagattttgggtagttgaggataaatatagaagaaaagaaaaacgtcttgggtgggggaaaaagaaaaacaaaatggtgtgcccggtcactcggaaggcaacttattcgtgaacaagagggacttttttattcttctacatcagcgtagataacatttatataacagac	ctattatttgtgtaaacgagacccgttaaaatcgcaataataatgctttgaaaggtctgaaccttgagaagagttggctcacggagcactgttttcgatgctctccaagtgagtgcacgaatttgttgaaaaaatgatgctccgaatctgggacgtccgaacgttgttgcatatcttcgacgccaatcctcactgaatgc	EtaKappa
aattttccagttaaaaggcaaaggagacgcagacagtgaggcactctagtttctctaggtctctatcatttactaactctatattcacatttgcatttttatcacatccttctgcacactgatctgccaccatacctgattagaatctaatctacatattggcatggaatacaaatcagccccacataaaagcccagcgg	tgtattctgtagtatcttccaacagcttttcagataatgcacataacttccgattctccagttgcataacaatccaaattcccagctcttttgaatttccatcacttcctgctgcacactgatctgccaccatacctgattagaatctaatctgcatattggcatggaatacaaatcagccccacataaaagcccagcgg	EtaKappa
cttctatcataacataatgactgatttcccccttctgtctcctgacaacatatttcctttggtgagcaatatgcattcaaattcattgaagtttgacattcgtgttggttcgagcatccagtagttggtttcaatggtgatccaaatgggcaatctgaaaaaaattcggtgataaatgtattcccattattctaaattac	tctcggttccgtgcggtactaatttttatcatgtttttttttcagattcgcccagttttcaaaaacacagttgtctacttgactggaggtttccgtacagttaacgcaatggttgaagctatcaaatccggagccacacaaggaattggtttgggtagaccgattactgcggagccagatctcccaaagaaaattctgca	EtaKappa
gttttacctcaactcggctactggtgttacgactggtctctgtactggttgtagtggttgttacagtcttctgcttctcatgtttctcttctacaaagacactattacgcggagtgtctagaagttcacgtgactcagtgagctcacggagagcacgttgaatttcctcatccatccattcagatgttctggaaataata	tttactctgaaagttacggaaaactgtctaaaactgattgtgagttaatttgaaatttttcactaaataatgaaaccctaaaaaggaaaaggttttgcagatagtgaataacttaaatataaaaaagtgaatttgatcaatatagtgagaattaaatgaccttcagatacctttaagctttcataaaactcaacaaatcc	EtaKappa
gcggacagtccacctctttttcacaaagatgaacaaagatgcaatacacatgttttccgacggcggtgggcagagatatttcattatttgatttaattagtctgcctatcattggtagttttcaatcgcttgccaagaaaattcaatagaatccagtttattttttgtaagagattttttttcgaagtattgaaacaaga	tagcatgtgactaacggcttttctatacggtctatgcacagtaacaattgcgatactctcggcgagaccgtgaagtccaaggctacaaaatgtaacattcatcatcgtctgataataacgaccggtcaaatagacaatgaaaacccaacctgctgggagcacggcaattagaggaataaaaatttggaataaaatgcaga	EtaKappa
tctgctcggaattatatattctcacaatttcttgatcgggattgaaatcaaaaattatcgatggataatcgatggatcttgagtcgaactcaattgaaatcggtaagcccatgaagatctgagcaatatcatagtttttcattgatattttgatgagttgttttgtcttgttcgaaataaatgaaagagtcaagctgaaa	ctcttttcaaaaaaggctatatctgcgcactccgtagttcatgtctgtgtcacttcccaggagagtagtctcctgggcagagagcggtggttcgctattcctgtccatttagcagaaagacagttgacggggacgaggcgagtcaggcctggtacaccgctacactgccctcattacatacataccctcccaaggtctaa	EtaKappa
aatttttataaagtttgagtaacaggaccacgtggtgccaggctgtctcatctcggtttgatctacaaaaaatgcgagaattttatgcccaaaaatgtgacgtcagtaaacacgtcgtcagtaaacttaaccatgcaaaatcagttgagaactctgcgtctcttctcccgcattttttgtagatctacgtagatcacgct	tgagtaacaggaccacgtggtgccaggctgtctcatctcggtttgatctacaaaaaatgcgagaattttatgcccaaaaatgtgacgtcagtaaacacgtcgtcagtaaacttaaccatgcaaaatcagttgagaactctgcgtctcttctcccgcattttttgtagatctacgtagatcacgctgaaatgaaacattct	EtaKappa
