taatagaggaaatacattgttgatagtgctcttcaaattttaataattattttgttcggaaaacttggatttttttaaaaagtaaaaatttctctaccaggagttttaacaagtttttcgttaaattcactacttttctattatggctttgtcttacaattgaacttttcaacattttttatccaatacccaagttcaga	atagaggaaatacattgttgatagtgctcttcaaattttaataattattttgttcggaaaacttggatttttttaaaaagtaaaaatttctctaccaggagttttaacaagtttttcgttaaattcactacttttctattatggctttgtcttacaattgaacttttcaacattttttatccaatacccaagttcagaaa	Pcn1
atggcgttagtgacgcaaactccgtattgcaaggacagaaaagggtttgcttcggtttttgagcaagtgagttgtattgaatggtcaaaacaaacaaaaactctagcaagtcaaaaaattgcgcgccaatccaaattttgaagcgtcttacgctaatttttatcgttgttaacgtacttgcctgttttaatatcgccttg	ggcgttagtgacgcaaactccgtattgcaaggacagaaaagggtttgcttcggtttttgagcaagtgagttgtattgaatggtcaaaacaaacaaaaactctagcaagtcaaaaaattgcgcgccaatccaaattttgaagcgtcttacgctaatttttatcgttgttaacgtacttgcctgttttaatatcgccttgag	Pcn1
tgaattcccttcttcaattaatgatggcccaaaatcgttgtaatagtatagaaaatacagtgctgcagaaactccaattgttaatagaatgtaaaaaaatatcacaaccttgtagaaatttgagagtattgggaaaagtatggtctggaaaaaatgtcattgaatttttctatccaatttttgtaaattgttttcaaaaa	cccttcttcaattaatgatggcccaaaatcgttgtaatagtatagaaaatacagtgctgcagaaactccaattgttaatagaatgtaaaaaaatatcacaaccttgtagaaatttgagagtattgggaaaagtatggtctggaaaaaatgtcattgaatttttctatccaatttttgtaaattgttttcaaaaaactatc	Pcn1
acgtacaattcttcgggtgaggcgtcaatgagcagcaaagtatgtaagagcaatcgggagtcaaataacaagtggaaggatttgagtcgaaagagcataatatgtgatactgtacataaatactagggtcctagattaaaaaaacataatgaaaaccttcctggggaagaaaggccttctcaagtcagcctttgagaatg	aatcgggagtcaaataacaagtggaaggatttgagtcgaaagagcataatatgtgatactgtacataaatactagggtcctagattaaaaaaacataatgaaaaccttcctggggaagaaaggccttctcaagtcagcctttgagaatgaaagagaggttgccctattttagactatcgtataatacagggtaacaaaag	Pcn1
aaaaagaatgaagcaagactttcatggaagaagaggaagaagatggaaaaactaattgaaagcatagtgcatattctccgcccaaaatttgaagagtgatcaaagcaaaatgatcactctcgaagcaaaatgcaacgttgctctatctggaacaaaagcaaattcctcggagaaaatgttttcttcaagaacgaaaacgc	taattgaaagcatagtgcatattctccgcccaaaatttgaagagtgatcaaagcaaaatgatcactctcgaagcaaaatgcaacgttgctctatctggaacaaaagcaaattcctcggagaaaatgttttcttcaagaacgaaaacgcttcaaatgtgatcgatctagaagaaatgagaccaaaagcaaattctaatctg	Pcn1
ctcatttttaatatctttaaactattcggttcttgaaatgttttgtttttgactacattccttttccgctcaattaggttatctcgttcccctcaattttgcatatttttgcataatgcgaaaatattcaaattttgaatttaagttccacccttgaaattgaatttttgatgaaaagtatctgttttattaatatgatg	ccttttccgctcaattaggttatctcgttcccctcaattttgcatatttttgcataatgcgaaaatattcaaattttgaatttaagttccacccttgaaattgaatttttgatgaaaagtatctgttttattaatatgatgaaatctccgaatcgtatagacgaagtttcttgccttttccaaattacagcattttagga	Pcn1
tcataattttggaaatcgcccaaaaaaattctatttgaaaaaataattattttaacatttgaatcatcggcaaaacggaaatcggcaaaccggcaaaaaatttgccgaatttgccggaaaaactgcaattgccagaaaatgcggaaaattgtggttttgcactttttttttggaaattttttaaagaaaattcaatgaaa	catcggcaaaacggaaatcggcaaaccggcaaaaaatttgccgaatttgccggaaaaactgcaattgccagaaaatgcggaaaattgtggttttgcactttttttttggaaattttttaaagaaaattcaatgaaaatatctaaagaaaacggggaaaaaaattttaaacggcacagttttaaatgtttccgccttataa	Pcn1
ttgaccttcttgccgttttgcagcgggttttcaaaaaaatctaagaaagggaaagatattttttgacataataagagtcaaaccgaaaagtcacctgatacgtgattaacaagctttccgagcggaagaaaatttattttgggagctgagaaactgaagtttagacttacaatattatgaaatagctagcgcggtggaaa	gacataataagagtcaaaccgaaaagtcacctgatacgtgattaacaagctttccgagcggaagaaaatttattttgggagctgagaaactgaagtttagacttacaatattatgaaatagctagcgcggtggaaacagacttaatcagaatatagaaattgatttcgtctttctgcctcgctaaacaatttgaaaagga	Pcn1
ttttacttctggtttttttttaattaattgattttgcggcactttttgggaaatctaagacatggtcgaatgttcgatcctctaagatgcctgaatataaatactttaaatataattaagctttttctgttttagcagtaccccacattgttttatgtaatttcatatataaaactggaacagtttgtttcaatagacaa	aatgttcgatcctctaagatgcctgaatataaatactttaaatataattaagctttttctgttttagcagtaccccacattgttttatgtaatttcatatataaaactggaacagtttgtttcaatagacaaattccaaaaatagctgaaaactaagttagtgtttgactcgaattaaaatgtttcctacagtttttgaa	Pcn1
tggacacacccctcggacgactgattaattttttagtcgaacagacgaaagatgccgtcgaaccgctcgtggccagtcgaatcttcaatcaatttgcggaactcgatggggttggacttagtagtactgcttattattcaaggttaatgatattcatggattttttttaagattacttgttcaggtttcatgaacacatt	agtcgaatcttcaatcaatttgcggaactcgatggggttggacttagtagtactgcttattattcaaggttaatgatattcatggattttttttaagattacttgttcaggtttcatgaacacattgctccgaatattggaaaatgcaataatttcaatgtggtgacacggattcgaatgatgttcgccttgtcggctac	Pcn1
aagatgacattgagcaaaaatgcaacttttgcaacaaaatagatgaaagtgacgtagtatgcggaatacttgatgttcagaaaacgcagaatcttgtgtggaactatctttttctgcaaaaaagtgtatttagatgattatcggtcatttagaattgcctaccaatttcagtcttttttggaatcgcaaaactcctcgta	aaaacgcagaatcttgtgtggaactatctttttctgcaaaaaagtgtatttagatgattatcggtcatttagaattgcctaccaatttcagtcttttttggaatcgcaaaactcctcgtaaatgaatgcacaatgcatcgatattcgcttttttgacaagtggaacagcattattctcatctgaagctactcgaagaatc	Pcn1
ggttactgtattatcctgaattcaaatcgaaaatgttggttttttttttgattttgtcgattttccaatgtctcaaaaaaaacacgatttttcaaaaaagggcgggcggcaaactgttttgtcgacaaattcggcaaattggcaaattgccggtctgccggaaattttcaattccggcatattgccgatttgccgatttg	acgatttttcaaaaaagggcgggcggcaaactgttttgtcgacaaattcggcaaattggcaaattgccggtctgccggaaattttcaattccggcatattgccgatttgccgatttgccggaagtgtttagaataattttttataagacggaaacaattcaaactgtgcttttttgaaatttttttcccgttttgtttag	Pcn1
tgaatgaaattatttattttttttttcttcgaatatggaaaatttagcagaataaagttgaatacacagtattcatataggaagctattggaagctctatcttcattttctactctctaaacgaacatcattgaagatgaaataagtaaagagcccaattctcgagcctcggctcgtcataacaccaccgatctagtgtg	ctattggaagctctatcttcattttctactctctaaacgaacatcattgaagatgaaataagtaaagagcccaattctcgagcctcggctcgtcataacaccaccgatctagtgtgactgagcaacgaaggggctctgctattttgccgaatagagagagactcccctaatctgggcgccgccacactgcctctgatatc	Pcn1
tcggaactttgcgtcgaaaacattgatgatcatttttattcaaaacacaacaacttaaaccaacagtaagaaacagtatatttttgaaatttggaaacagtattttgaaagtgagaatatttcaaatttttaaaggcgggggaaaaacgtttactattgtaaagcaaattgtcctgaaaatattatattcgatagtcaga	aatttggaaacagtattttgaaagtgagaatatttcaaatttttaaaggcgggggaaaaacgtttactattgtaaagcaaattgtcctgaaaatattatattcgatagtcagaaaatttcatacaaaaaggcaatgtcctcttccagtttctgaaattaaatgagttcattgaaacagaaaatattttctagagaaatct	Pcn1
gaattattttcagattgacacgaactctgaccacaaacaaagcggtttcaaagaattccctaatccttttttccttttcccctgcctcttctgtttaagtctaattaactagaatcaaagcattgacaaatcaatgggagagtttttagtgagcaatgatgaaataaacagagattttattttgggtgtacaatagattt	tctgtttaagtctaattaactagaatcaaagcattgacaaatcaatgggagagtttttagtgagcaatgatgaaataaacagagattttattttgggtgtacaatagattttatgaacaagaagttttatgaaagtttcaaaaagagatcgtcaagtatcttcaatcttaaaaaaaatatttggtgagagtgtttaattc	Pcn1
aaattgttcaggtttcaataaatggggaaacttggtgccaacttccacctcaccacccaccgattccagctattattagcgatcgatctcagtattcacaacgaattgggagagacagggtaagtagactaattattgggttctgttcaaaaacaaaattgataaagtgcaaaaataggcgctgagggtaatcttctgtt	tcacaacgaattgggagagacagggtaagtagactaattattgggttctgttcaaaaacaaaattgataaagtgcaaaaataggcgctgagggtaatcttctgtttgaaaaatagtagtatacataattgaggtttaggtgagttagtataaatttcgaatgagtgtaactttgaaactaaacacaactagtttcaaaaa	Pcn1
gcacctagaatctaaaatcgtgattttatcaatttttgtctttacacttatatgccgaacctccacattttccccaaaaaagttttgcatttttaatagcctatatctcaattaattttcaagaaattcctcgaaaaaatcataatcgaattcaaattttcttttccctcttttctttttgtttgtttgttttagcagcc	ctcaattaattttcaagaaattcctcgaaaaaatcataatcgaattcaaattttcttttccctcttttctttttgtttgtttgttttagcagcccctcattttgtattttcctttcttgttctgtgaggtaaaaagaagatattttccttcgacaaatcatgtagttttcagatagcaaaacattcaataaagatacatc	Pcn1
tttctcatcaaaacaatccaattttcggaagtcactccttttcctttcccgcccttctttctttttctgggcggagctttgtttgtgtgtgctctttctgccggctccacccataaatgttgatgctctctgggacttttatgccctctgatttcacggattttttattgaacttttggtttaacattttcgattattca	taaatgttgatgctctctgggacttttatgccctctgatttcacggattttttattgaacttttggtttaacattttcgattattcattattcaaatttcaaaaaaaaatccaaaaatctccaaacttcgttcgaaagttgacacacaactaaacgttcgaggaactttttcgatagttttttgtagtgaaatttggtac	Pcn1
tcaataccaaaataatcccaaaaaagtgcgtaaatcttgcaactaactcccaaaataaaaataaaattgatctatagaattgcaatgttttgtccttcttaagatattctacctatcgcctatttcctgaattataggcacaaaaacgacgtaggaaggtagggattttgtacctacgtcaaaaaattagaaaatttttt	tatttcctgaattataggcacaaaaacgacgtaggaaggtagggattttgtacctacgtcaaaaaattagaaaattttttaaaattaaccgagatataacccaaaatggagtactgcaattctatgcactagtggaaattcggtataccagcttcctaggctcgaaaatgcctggttgccgcctggctcactttttaatc	Pcn1
gattatagtgatttagaagagcatttcaatattccatggttttttttttgaatgatttggagcacttattagtttttcaggagaatggaaattatgaaagtaaacgaatttcttggaatctttttggattgcgaaaaagaaacttgtgaaggaggaaaatggacaattgaatgatcaagccaaaatggaacagtttgaca	ttttggattgcgaaaaagaaacttgtgaaggaggaaaatggacaattgaatgatcaagccaaaatggaacagtttgacaccacgtgccatacccaaaggtctggtgggcccacagacccgctattaaggatttcttagtccgggtaacgctctttatttatttataagatacaaatgcttataaaatgtatggttaacag	Pcn1
gatctataaacactaaaaaattaccctttttaaaaatatatcggttttgaacaatttcagaaaattattttcttgcccaaataaaaaaaagtacagtcattacatggctgaaaaatcaaaatgagcaaaaataaaaagttgtctaaatttgttgaaaacgggtaattcatatacgtagaattcagaaaaactaggtttaa	gcaaaaataaaaagttgtctaaatttgttgaaaacgggtaattcatatacgtagaattcagaaaaactaggtttaatccatcaaaaactattaaaaagtggcaaaaatggacaagcatgggcaaaaaattacaattttgaaagtcctctaaaatggttaattttgtagttagacgactcaaaattaatgtcagaacccta	Pcn1
ctcctcaaaaaatgtaaaactattaaaatctagtttggagcattttaaaaaatttcagctactccagacaaattttagagaatgctttataattttttgctacttttggaacaattcacgccatttttggccaaaactctcccattttatctgccctgctcccatcaatcaacgcatttctgccaagcagcctttaataa	ttggccaaaactctcccattttatctgccctgctcccatcaatcaacgcatttctgccaagcagcctttaataaatgccgagtgtggcgactccgcccctttttcgcgttttttcgcgttttttttggcttgcgaaaaaatgtcacacttcgttttcattaataactccagagccgtttgactgaattttataatatttg	Pcn1
ataatagttgtttaacttttaaaattttatttaatttttacaattatttggtagttttctgcttgccctttgacattcttgaaaaacattagcaaatgtgcaaaataaagtaaattggttgattttttattaaaaaacagtattttcaatattgcaaagcaggcttagttctacatattgatccacgtagacaaaacgtg	taaaaaacagtattttcaatattgcaaagcaggcttagttctacatattgatccacgtagacaaaacgtgccagcttgggcaacattgcaactgaaaatttatcagttacgaagtacgccagcatttgtcccactaacttggttgcaaaaatagttccgccggacatattgactaggaaagtacacggattgccattaaa	Pcn1
ctagaagcctcccattgccgtgaaggttgcttaaagattcacagtagaataaacaatccgaggctagttagtttatatagaattcttactttgaataaacaaatgaaagtcaatggaaagacgtctggtcaatcggtcagcggcgcgacacacgtctgcagggtttaaatagatgagccgtcgtgcagcagttgtgtgga	tcagcggcgcgacacacgtctgcagggtttaaatagatgagccgtcgtgcagcagttgtgtggaccgttcgagaatcttcttctgtttcacagctgtcgtctccgcctggaacacgtcatcaaaaaagatctcgtcttttgcctgtggtgtcgaccctagaaatgcggcgtgccggccggtgaccccaaatcatttctta	Pcn1
atagtgatattttttatcgattatttcggatttttcacttttttatgtctgagatagccgtgctttttctcactaactaaatttttgaaaaaaatggacaagatatctgatgcataaatgttctttgattacctacaaatgctccttgacttcagttttttttctccaattgaaatttcaagattttcaaatgatcaaat	tcagttttttttctccaattgaaatttcaagattttcaaatgatcaaatttttcagcatttttattgtttatctataaaaaattaacaacaaaaattggtaagataaaatttaaacacctggaactgaacaatcgccttcatctcgctgctcacgctgctcaagcaaatcgaatgcttgccgaagaatcggaattggtag	Pcn1
aattgaaatgatgatgttgatgatgatgtcctctttctctctctcatgttgcggacactcattcggacatgtctcggagcaagcagaaaagtgacggctcacttcctccatctttcctttcactctctctctctctctgccctcgtttttttttcttttttacgcataggtaattaggtgggttggaaaaaaatgtcgcc	tcttttttacgcataggtaattaggtgggttggaaaaaaatgtcgccaaatcccagggagcccctaaaattggaggcggaaattggcgagcaaaaagagaacaaaaatcaaaatgtctagcggggagtcgaaccggggacccttggagtcgaaggcaaaagcgttagccactcggccatcagtgctcggttaggctggaa	Pcn1
atttttgttacattttgatgtagcttaaaatattttcaggctcgttcagtattcactgagaacaaatcgttcgattcttatgctgaattcaaacggaaacacactcgaacttctcgtgattcaaactcctcaaacgccacaagatcttctcgtgatttcaatagtttgccacgtggcaccacagctcagtcatcactgga	ttgccacgtggcaccacagctcagtcatcactggatcgcaaaagagacacttcgttgtcgagctaccgaaccgcaaaagataatttcaactcatcctcgaacagaagcagtggaagaagtgaatatggagattacaggttaatattactccaattaatcgtagctgaatataatcagttacagagtttcaaattatcaag	Pcn1
accccgtctaaacaatgcacacacttattagtttaggaagaaacttcatagaattgtgagccatgtcgctttgatgtcaaaaatctctggagttgcgaccatttatcggcttaagacccatttctctaaaactattggacagtataaacattaaccaatatattagaattatagaaaattcggaatagaaaaaattcaca	attatagaaaattcggaatagaaaaaattcacaaaaattttaaaaaaatttaaaagacgtctgagaaactttagtggtcaatatggtcgttggttctgaaatctcaagtcaattaacggtgggggagttttacgaatctcgcttttcacaaaaactgaaagtaaaaatgtttgggattaaaaaaatttttaattttgggg	Pcn1
ggcctcgaaatctcggaaaaatcttccacactgatttttcaaggcctataaggtttgacacagggaaagttataagcatatcttagagtttagttttctaggccaccaaaaatattttctaggccatcatatgctatttttcatatattctcattgctcatcttaatcaaaaaaaccttttccattttccttgactcatc	ctcatcccttccttctcctcttctttttctttctctttcctgttattttcccgttccgctcagaaattgccatgttggttcttatttttcccttatttttttttgcagagtccaaaaaaaagaacacggagcaattattgtgtgctccgaaaaagctccgcccacttctagcccttgtaatctgttaggaagtcaagaca	Pcn1
aaaaagaaaagtctcaaatcacggtacttttgcatttaatacctttagaaaaaactgctgcagttttttcgttataagacctgtttttctgtgatttccctcttcgcttgtgcaaaaatagactccaaatcctcatcttctcaaaatgtttgtcacgttgtctactacgtacttgcttaacatttcgttgtatcctataa	taataataataataggaaaaggacaatttcaaataacataaacaatttgtgtgtgtgtgtgtgtgtcaatggcttaatcttgttaaccaatatgtgttcatgaacttcacatttgaactttccattagattaatctaatccaatgaggcttcttgaatgagtttcaaagtaactatgagaacaagcagttaatcaagtca	Pcn1
ctcctatccaaatttgtatccaagtcctccattgagtgagaatggaaatcttacaactccactcgatcaaccgttgactgtcgaaatcacagaagttaatcgtgaatactattctctagtaccttgcttgcagttttttcaataacttatacttatttatgtccaaacataaaaaattgcttgcttaatgagttgttctt	aacatgaaaaataacttgcaacatgaatttttaattactgaaaaatctcaagtcttctattcgctcgtttttgcactcgcgcgactttggccatgaaaagcaacaaataaaacctacactatctcttggtactcaaaatgttgtgtaatttgattttttctggagtaaaaccgaaaaacaacaaagtgaaggttgctgct	Pcn1
atagctggcggcagccagatctcggtgttgcctgaggaccagtctattcattttctttgagtacagtaatttgcactgcaagtttcaaaggtatcgaatttttcgttgattcgaatgccagttgtgtacactctattggagctgttgccatcgaaggacttatcaacaatgcaaaaagcgagaggaacaataattttggc	atcatctttctcctcgtagttgatggttttcttctttcgaagattgtaccttctgttctgatttggctgatcaatttcagtgttgatctcgctttgcccatttgcgactacttcttggatcttttctggaatattttccatgttatcctccatgacattttccgcgtcttgagcgtctgtttcatgttgaatctcttcga	Pcn1
gacatgtggggtatgggagtcgtcactttctgcctgtaagtttaatttttaattttattttaataaaccaacaaatttcagtctcgctggattccacccgttcacttctgaatacgaccgcgaagaggagatcaaggagaacgtgatcaatgtgaaatgtgatccaaatttgattccagtcaacgcttcccaagaatgcc	tttttctagttctagaggaagagttcaagatcatgaaacattgcggactgttgcaatttttgaaagtcagaaagcctgaaagaaaatcacgaacagatcttaaatttataactgttatttccagatactctgcatcaagactccgaaagcttgccgcaatgatccgccagccaacattcagccaaccaatcagcgaagag	Pcn1
tgaaatttctagttttttggtattatcaaaatatataaactgacacgtgaaacgtggcttattttttattttgttttttatttaagcgcctcccattttttttaaatgaacttaaaaataaaaattttaacgaaaggtcaggaatgggaggagcttaaataaaaaccaaaataaaaaataagccacgtttcacatgtcag	atagcgttcattattgccagaaaattattgccgtagtgcatttaaaaaatttcgtgactggaaatcatgacaaaccttgtagcagttgtttcctcgtaaagttatatcaccagaactagttttttgttctctcatgctgtgaactagtggtccacattctgttggtaatttcaaatcagttatcatagcttgaaaatctg	Pcn1
gaaaattgtagaaaatacattttcggtcgacttctaacattaagatgaatgaaatctgagttattcaacaactttgagaaatagttgaacagttttaataaaatgtttctggatatttgctcagtaatttcgctactccactcttaactcaaagttgtatttctgctgaaggtcccgcagtgaatgggcacatggcgact	gttggaaaaaattttgattttagctaaaaatgggctttattttgccgaactttgaaccgccgtaactttttttgagaaattttcagaacttctcattacgaaattcggtagttttggaccaattttggtctaaaaaagcaaagtctcaaatttcggtactccccctttaaactcacatcagctcaaagaacaattttaac	Pcn1
acaaggaatggttttaaaacaaaaaaaataatatttttagtaaaaaattggtaattgcctatttaaaacgaggtattatccaggggcgggcggcaaatgatttttccggcaaatcggcaactagccgaaagtttgtgttttgtttttttggaaatttcagaatttcaattttaatcggcaaaattgtacgcaccttatgt	acagtgttcttagatgttcagaatagtcaaaacttcttcagaatatgaaaattgtagaaaatacattttcggtcgacttctaacattaagatgaatgaaatctgagttattcaacaactttgagaaatagttgaacagttttaataaaatgtttctggatatttgctcagtaatttcgctactccactcttaactcaaag	Pcn1
