caagatctgaattctaaaatatagaaagcatattgcatttttgttcggaaaatattctgtagaaaatcccgaaatagatttcggcatctgaatttattttaaaaaaactaaccagacaagtgccaacagctttgaacttcacacagttgatcagttttttaaagttataattttccgaatcgtctgaaagttcaattggt	aagatctgaattctaaaatatagaaagcatattgcatttttgttcggaaaatattctgtagaaaatcccgaaatagatttcggcatctgaatttattttaaaaaaactaaccagacaagtgccaacagctttgaacttcacacagttgatcagttttttaaagttataattttccgaatcgtctgaaagttcaattggtt	rev-3
atgatgatcggtttcgcagcttcttgcctctctttttccctcttctagcccttgttctgttcccgcgtatcctctccgtctctgtgcgcggcgggccccaccaaactgacgggacaagcagcgacgacgcgcattttccaaagtgtctcatatacttatccgtcagtcttctggcgccacgccacactatatcttatgta	tgatgatcggtttcgcagcttcttgcctctctttttccctcttctagcccttgttctgttcccgcgtatcctctccgtctctgtgcgcggcgggccccaccaaactgacgggacaagcagcgacgacgcgcattttccaaagtgtctcatatacttatccgtcagtcttctggcgccacgccacactatatcttatgtat	rev-3
actgcaaacaagcttctaacttgattttaaatgattgaagcaatctgaaattttacacacacatagcccagtaaaattaaaattagctcaaaaactttcgaaaaaaaaatccgataactgatagacaagttacgcaaaaagtccagactggccggagcgggcgaaaatttttgacctaccttctcagcaccatcagaatg	ctgcaaacaagcttctaacttgattttaaatgattgaagcaatctgaaattttacacacacatagcccagtaaaattaaaattagctcaaaaactttcgaaaaaaaaatccgataactgatagacaagttacgcaaaaagtccagactggccggagcgggcgaaaatttttgacctaccttctcagcaccatcagaatgc	rev-3
agggagaggaaaattcgggaagagtcgagaatttggcggcagtttgtgagtcatttgactgtgcatttacgtttaagtagataacagttgccacgtttcgttttttcatgacataaattatttttcccatgcagaaatgttatcgagaaagataaagttcagcgaaataaacataaataatttaacatatcaaactagta	gggagaggaaaattcgggaagagtcgagaatttggcggcagtttgtgagtcatttgactgtgcatttacgtttaagtagataacagttgccacgtttcgttttttcatgacataaattatttttcccatgcagaaatgttatcgagaaagataaagttcagcgaaataaacataaataatttaacatatcaaactagtaa	rev-3
tatcagatggtttctcgtttatttttaaaacaaatatttttgtaaagaaaacaattgttcagtaaaaaacgagtacagaaaagaacaaagtgaaacagtcgtgggtattttatataaaaccgaaaattcaaaaaaaaaaccttttcgaaaagtaccacatttactatctcctgtttaaattcggacaatttaacattacg	tcagatggtttctcgtttatttttaaaacaaatatttttgtaaagaaaacaattgttcagtaaaaaacgagtacagaaaagaacaaagtgaaacagtcgtgggtattttatataaaaccgaaaattcaaaaaaaaaaccttttcgaaaagtaccacatttactatctcctgtttaaattcggacaatttaacattacgag	rev-3
tagcattaggagagaggaggatgaggaagttttcgggaagacgggcggcgagttggtgccacttgtcggtgaagcaccgccagtcgacgtagcaccacgtggcagaagcccgtcaatcgagagccgcattggggtggagaacttggagcccgagattggataggccacgttttccacgtcggacttggtgttggtggact	attaggagagaggaggatgaggaagttttcgggaagacgggcggcgagttggtgccacttgtcggtgaagcaccgccagtcgacgtagcaccacgtggcagaagcccgtcaatcgagagccgcattggggtggagaacttggagcccgagattggataggccacgttttccacgtcggacttggtgttggtggacttttg	rev-3
aatgagggtgtataaaagaaggaaaagtgcaataatagatgagtgtgtatgcatgtgtatggggaccactaaaaatgtgagagaatgtgtcaaaatatgtgtgagtgagtggaaaaaagtgggaggaagaagacaaaaaacgatgaagaagccgacaaaaaaaaagaaaaaaggaagaaagaaagaggaggagaaggaaa	agggtgtataaaagaaggaaaagtgcaataatagatgagtgtgtatgcatgtgtatggggaccactaaaaatgtgagagaatgtgtcaaaatatgtgtgagtgagtggaaaaaagtgggaggaagaagacaaaaaacgatgaagaagccgacaaaaaaaaagaaaaaaggaagaaagaaagaggaggagaaggaaaaaag	rev-3
tattttcaaattaaaccacttcattcctctgtgaaaacaccgtgctactcctatttgtagttttggggttcagaatcgtggatggtcgtttgaatattgctaaaagaaaatcatttgataaataattgatctattatagttcactacctttgatcgcatttctatattcaggaacaattagcattagaatgaggctatca	tcaaattaaaccacttcattcctctgtgaaaacaccgtgctactcctatttgtagttttggggttcagaatcgtggatggtcgtttgaatattgctaaaagaaaatcatttgataaataattgatctattatagttcactacctttgatcgcatttctatattcaggaacaattagcattagaatgaggctatcaatcgg	rev-3
gggttgaatttggtttgactaacctgttgctgggcaacacagctctgttcacaggagctctgacaagttggtgcacactgttgttgctgatactgttgagcgcatccgcagcttgatggctgttgagcttgagcgcaggagcaagattgttgggcggtgttggtttgagctggttggcagttgcattgtggagcagctgg	aatttggtttgactaacctgttgctgggcaacacagctctgttcacaggagctctgacaagttggtgcacactgttgttgctgatactgttgagcgcatccgcagcttgatggctgttgagcttgagcgcaggagcaagattgttgggcggtgttggtttgagctggttggcagttgcattgtggagcagctggaatggc	rev-3
tgggcgctgctaaaactacaaactacaagttttttggcgctgctaatgcatttttagtccaattttctaatttttcgttttttttttggaaaaaaagtgccaaacgtcaaaatgggcgctgcttttcaaaaaaaatcgatttttcgtgcaaattttcgcgatttttgccaatttttcagcagaatatagcattttcctag	tgctaaaactacaaactacaagttttttggcgctgctaatgcatttttagtccaattttctaatttttcgttttttttttggaaaaaaagtgccaaacgtcaaaatgggcgctgcttttcaaaaaaaatcgatttttcgtgcaaattttcgcgatttttgccaatttttcagcagaatatagcattttcctagaaatttg	rev-3
aatagaagattcaattcaacaacaaatgtaaacaaaaatgggaaattaaaatttttggtagaagttttgagaagaagcggtgggagttgcagcatcaaaaaataagtttaacatagaatacaagagacctattcttaccattaatcaatgaatttcgacaaaatagatttattcgccaaatcagttaaataatacagcca	taaaatttttggtagaagttttgagaagaagcggtgggagttgcagcatcaaaaaataagtttaacatagaatacaagagacctattcttaccattaatcaatgaatttcgacaaaatagatttattcgccaaatcagttaaataatacagccatgtgagtatttctgtgatcaagttcgaaccaatgaaaaaaatgcag	rev-3
acttcatcgagctgtttttcaaacgtctcatcgtataatttatcggtctttcgaattctaataagtgatttacgagcttcttcaattcgtcctttttgaatgagccaacgtggagactcttcaagaattctgaaattttacgataggagctttgaaatataacaagtatcggtaaaacttacaaacaagctaaaaatgtt	ataagtgatttacgagcttcttcaattcgtcctttttgaatgagccaacgtggagactcttcaagaattctgaaattttacgataggagctttgaaatataacaagtatcggtaaaacttacaaacaagctaaaaatgttgcaatagaagaagctgcaataacaacggacattgttctccaatcttgacaaagccatgca	rev-3
aacgtgcgggcctaaagtgttggttttgtacctacatgcgtgtatttaattcgagtgtaagtaaaccaagaaactaactgtgatcttgaatcgataagcacgcccagtaattatttgaaaatggaacgttcattggtggcaacatcataatattttgcccggagaccagagggtttgcacagtaaattggatacggagga	gaaactaactgtgatcttgaatcgataagcacgcccagtaattatttgaaaatggaacgttcattggtggcaacatcataatattttgcccggagaccagagggtttgcacagtaaattggatacggaggattgtaaattggctgataaaatattgatttactttagcctgcataaggggctgtaatgaagaggagtata	rev-3
ttctagaaagcaatgcacagcgtgaatatacaaataaatccacttccctgtgtttcttgatttgtttttatcattttgcaccaaaaaccagaaactttgaagaaaatttaatccaaactctgatcattggtgacaagaaaacagtagaattttctaggcaggaagtagtttgcagaataattttcaatacactacatcgg	ttttgcaccaaaaaccagaaactttgaagaaaatttaatccaaactctgatcattggtgacaagaaaacagtagaattttctaggcaggaagtagtttgcagaataattttcaatacactacatcggtggttttcataatgatgtgagggggtccattcttcggcccattgatttattcaaaatacatgtttaggatcaa	rev-3
aattattaattttctttttttttttttgaaaaaaaaacctactcatcatcataaatccgtttccttcttgattgtttctcagacgtcgagccataagccataagatttgcgtactaaattaataataatccagtgaaaagttgaaaatttttaattttttcatgaaaactaaaaacctcttgttccttcttcatttcttg	agacgtcgagccataagccataagatttgcgtactaaattaataataatccagtgaaaagttgaaaatttttaattttttcatgaaaactaaaaacctcttgttccttcttcatttcttgctcttttcgatttgacaagagaatattccgatttggtggtggaacaggcgcatttccgactgttaaagctgcaggaggag	rev-3
ctccgtttctgttctcgcagatacttctacttttgccaaatgattaacaaaaaaaactgcgacgcatttaatactctccaaaacgatttgaaaattttaaagtcaaagattcgaatcctcaccttgacacaccatggcccgctggggcgttcaaacttttcccagtctgttgggcacggcactgaaaatcagacaatttt	aattttaaagtcaaagattcgaatcctcaccttgacacaccatggcccgctggggcgttcaaacttttcccagtctgttgggcacggcactgaaaatcagacaattttgtgttgttcttttggcgacacggaaactcactttcagtagttgtagtggtagtcatagtcgtggttgttgtggtagtcggtgtcgttgtcgc	rev-3
tcgtcattcccatcatactattatccacgtcatacagtgccaaaatagctccaaaatgtcgtgatactgatatgaactgtgctgtttgggtatgtgattattgatcagatatgtagaaattggaaagaattttcaggttgccacgaatacttcagattgcgaaaatgtggagctagtcaattcacattgtccgagaactt	gattattgatcagatatgtagaaattggaaagaattttcaggttgccacgaatacttcagattgcgaaaatgtggagctagtcaattcacattgtccgagaacttgtcaaacttgtggagaaccaatagaccccagtaagtcgtttgcgacgttgcctgaaaaagctcgtagctacatccaactggcatgtgtgacgtca	rev-3
tataatgtataggcccaacatgtgctcaaatgaacgaatttcgtaacaaaacttatatgttatcaactatggtctttcatttgacaatagtcacaaaattttttggccgtccgaagtgccctaactcggagccatttttttcaggcatttttcagatcttcttttcaggtttcaaatgaggtttgtgtgcggattttgct	ttttttggccgtccgaagtgccctaactcggagccatttttttcaggcatttttcagatcttcttttcaggtttcaaatgaggtttgtgtgcggattttgcttagtttagtacacaatgtaagaaaacaaaaaaagtttggaaaaaaatccgtccaaaacaatttttttgtcggtcgtcaaaaaaattttttttcgaaaa	rev-3
ttaaggttccatatagaaatagccccagtataatttttttttcaatttctttttcccggtatattcagattacttgtcagattgttataaaatttccagactctaagccaattttaaaacacgcaaaattatttcagcttggccgaaaaaaaattaaaaaaaactaaattttcggtttcaacaccacattttataatcct	actctaagccaattttaaaacacgcaaaattatttcagcttggccgaaaaaaaattaaaaaaaactaaattttcggtttcaacaccacattttataatcctcaaaatgctagaacagtagtgagaaataataatagaacttcatacactcagaataaaaaactggaataaatctagcaacgtataaataaaatgttggta	rev-3
atcggcaaactggcaacttgcaaatttgccgatttgccgaatttgtcgaaaaaaattaattgtcgcccacccctggattacattacgctcaaaaaaaggatgaaaaagtcaagtccagctctgactgcagaaaatcaccggctaccacaaaatcgtttgtttagataatcttcccatctcctctcaaaagcatcactatt	tgaaaaagtcaagtccagctctgactgcagaaaatcaccggctaccacaaaatcgtttgtttagataatcttcccatctcctctcaaaagcatcactatttaataaaaaaatttaaacaatacaaaatttagtgcaaccatgtgctgagaagagggggatttggaaaataatgggatcaagcttgcaggactcccagtga	rev-3
ttctttgatttttcgctcttcttcttctgaaaatttgaaattttatatagaaaaggttaggttttctgattttaaatttaattaattaatcttcaacaatgtgcaagcgcgctccaatgatagaccaaaaattcaaactttctcgttcattgtcgccgatgcccatgtcaaacatttttcaggtctataacggggcccat	tgcaagcgcgctccaatgatagaccaaaaattcaaactttctcgttcattgtcgccgatgcccatgtcaaacatttttcaggtctataacggggcccatagaagagctttgtcattggagcgctcttgcattcttatttcaaagtttgccttttcctattgtagtttgatcttcacgattggcgggaaaatgagttttaa	rev-3
agttcgagcactaactatccatttatcgaacaaacaacaaaataatgaacgaaagataacaaaacaactaattcaagaaagtatttcaacttttttatcctttgatttccatgaaattgatgttaattttcgtttaaaaaaaattgtcgttcacccgtttccgagaccacgggtgagcgagtcacccgtcactcgtgaaa	attgatgttaattttcgtttaaaaaaaattgtcgttcacccgtttccgagaccacgggtgagcgagtcacccgtcactcgtgaaaatgcccaaaaacgggtgaacgggtgaaacgggtcacgggtgaatccatccctggttacaaacagaaaattatgatattaattactcataattcccaagtgactcgacgtcaattt	rev-3
gagtaagagatgtgcgcctttgagcactacagtaacccactccacaattcattcgagtgtttcctgattctttttttggtgaaaaatttaacaggaaaaccatttaaaaaaaccgaaaaaaactgaaattgggttactgtactttttaagggcgcacacctctccgcgcagtctcaatgcgaaaacattttgttcgtggt	attgggttactgtactttttaagggcgcacacctctccgcgcagtctcaatgcgaaaacattttgttcgtggtgagaccaaacatcgtattttttgaccacaaaattgtaaaaattagaaaaaaaactcgatcactctccaaaaagaaaacaatggaagacgttttttatttggtggccgagtattttctaggtcacgtc	rev-3
taagatcaaaacttctcacgtcaaacaaaatgttgacctctttgcatcttctcatttttgaagaaagccgtatctatatttagaagcctcccgcgccgcgtgattcatcaatatttcaatggttcaatgtttctagtgtttgttcttctcaacgatgacttttttgctgcacatcgcgcattctttggaataattttatt	cttttttgctgcacatcgcgcattctttggaataattttattttattctccaagattttcgagacatcaacattttcagaagaaggcggcaatgatgatgataggggaaaaaaagaagaggatgaagacatttgattaagcttaatgaacgaaaaagacatacggacaacaacttcatcgcatttttccctttttcatgg	rev-3
aagcatagagaatcaaagagataggaattggttctcaagtgactcatacaatgttttactagtctaccatacttttcatatccgttttacaatgctccactttgagggttcctaagttgtattatggttttatcaaaaagattaacaggaaaaatacgtgaatgatatttttctatattttaatggttaaactattaaga	atatttttctatattttaatggttaaactattaagaaaccatcatgagaatatatactttctggggcgaaaatgaaaacagcagagagaatatgcggcggcgtgagattaaggcgcgtttgctacgatgtattcccgcaccaaaactataggcattctcatgatctcatggtatcttaacagggcttccatgaggcagcc	rev-3
cgaacaggctgtcatgtcgactcaccagtattattattgttgttggtcgtcggagaagcgtggtttttcccgtgatgttcaccggcatcgagacgaagaatatcgaggagatcattcgctaaaaaatagaaattaaataaaaagttagcgtgttattctataaaaaaagagaacaatgtgtcattgtagaaggtgtgtga	aaagagaacaatgtgtcattgtagaaggtgtgtgagcatacaaagatgaccctaatgaactattagtattgtaacaagtataggtcatattagtgtcaggttacccaatagttagtctagcacctcgagcacagcgggaagcttgttcaagacacaacttgaatgaaaaatgaccggaaatacttgatcgggaaaaacac	rev-3
ttagataagttttattaattttaaacattgaattaaaattacattcatgagctggttagtaaatatatttattatatatggtttactatatgtacagtttaccaatttgttccagacctactaatctattgacaactagtgtgtctattcaatttggtaattattcaatttttccctacttaaaagttgaacaaatttgt	ttttgaatttattataatgtattaataataaaagcagaaacaagtaagatacaagttattagacaagttattagaagttattacactacaaaaactatcataaaatacattcgtgtagtttgaggggaaaggaagtatatcaaaacatggtaagttagttatggattgaaccccccgacaacctaaatattcatgacttt	rev-3
tcagggtcaagctcagatctaagaaatgtttgagcgcgaactcatttccaaaaagttataaactgagaaattcggccaaaactttacagacacaaatcacaaccaccccaaatgtgttacaagaacattcatttactccacaggggtcctttcttttcttgtcgggggagtttatggtacaaagtaaagtggtcattacg	taggttcaaactcccgcctactcgattcaggctgcaaaaaatggatcagcaagtgcaccatgcagaagttttgaattaataaattaaaatttaattgtttaataatatttaaacatgcaaactttcgaaatacgaaagtgtcaaacaaactgaaaatgaaaatttaccgagtagacattttctggattgggaatattgag	rev-3
tgttctttggactggagatattccgattcctggagctgctgaatggattaatacattacttgatgatccggaaaagagtgtttttattacaacgaataattcgacaaagactttggaacaatatatgcaagtttttattgtaattaaagaacatttctcacaattcaaaaaaagatatcaaaaatttgatgaatacattt	ccggttttttttaaaatgaagtacatatatgattttttaataaaattccaagagaaatttgaaaaaaagaaccgatttatttaccacaaattttgtgtcgaaaacttaaattccaaataaaattctttaaatttttgaaaacggttatgttctgtcacttcggaccgttttttgaatattgaaaaaaatcccgctgtttt	rev-3
catagagaaagtaaactaactaaataatggtcatcctacatgaaatcttcaccagttgtctgtacctttacaataaaattgtgttgttcggtaaaaagttactatatcgaaatgattttttcgcagcacctgagctgtgtggtaaatgtacaaaagtgccttattcaatataatcgtccaactatttagttttaaaattg	aaaaaaatgaacaaatagggtttaaagttttccggtaaagagcagttttcaggcactatgtaaggttttttttcaatttttttcatcaaaataaaatactattttcagatggaacgaccttttttctacattttcataccaatttcacatagatcgaagaagtttgaaaatcattttctaaaatattcgccgaagagctc	rev-3
agtttttcgcatataaaaacttaaaatttaacttaaaaccgtgatttcttataattttcatcatttttctgaatttttgaaaagttcggtacaagtggctcagtgggattttcgccgactaccaatcacaagaccggggttcgaggccgcgctgaggtcaaaaatttttgtagtggttttttaacgttttttgacaattc	gagctttttacatataaaaacttaaaatttaacttaaaaccgtgatttcttataattttcatcgtttttctgaattttcgaaaattttgtccaagtggcgcagtgggattttcgccgactaccaatcacaagaccggggttcgagaccgcactgtggcacaatttttttattgtgatttttaaacggttttcggataatt	rev-3
aaactttaaaaaaaaacactttttctttttttttcctcaaaaccaatttcttttccaggttactcgtacgatcacgatgacaacgttgccgtcggccaaattttcaacgacctggcaatgtcggattcagatgaagatgaacgggcagaggatgtgaaaaggcctgctaatggagatgataacctgttggactcgtttta	tctgttttaattatattatttcaagtatttatttttctcttccccgaatttttttgatctacgatatgaaatttcccacaatttttttgcgaattttttcaaaactttaattagacccttcagtaacctccagcagtggaaccaaaaatttgaaaattgttactatgaattatgtgacgaattagttttgcttgaaaggg	rev-3
tgcgtgatggtacctggaattaattggaattatagatgggacaatacctttttgaatttcagcgaaaattaataggaacttcaagttcttagctcattcatttgaactctgagaagaaattccgagtttgtgtattgcgggaacacaaaagtctaaaaatgcgtactgatcaacatatctgacgcgcaaaatatctcgta	acgggtttctgcgctctctcataaatattgtaattcacgaaaatttgacatttcagtttaaaggcacacgctttttttcaagagggtctcgccacgatcttggtcttggtagtaactacaggtgcaaaattttatagatttgttatttttatataacaaatgatgttgattattttgtatttatcgtattgtagttaaaa	rev-3
tgtgacagtgatcaatgagttgcggaggtgtgcatctccagttttgaaacggaagcaaacgaagttaaggtcagtttgtaccttaatagacttttctacatagggttatttaatttcagcagaaaactagagtcttttatcgggacaccgctcgagtacacctgcgccgcaattctcgaactactgacatttgccaattt	atttttatagtaacgcttttttttgtcattcaacctcttacaaaaaaaaactccctcaaaaaaaactaaaattataatgctatgacaaatgacgtgcaaacatcatgtacataaataagggttcgagagagaaacggtccatgtgatgccttcgccgaataggagacctattggggctgacgccaaacatttccatatgt	rev-3
ccaagaccaaaccgttcgcactttttaatccggtcgcttggaaattggtgatgatgtattcttattaatttaaagcctcagacggcaaaagtcttgtccttgctattggctttcccggcaaaagaaatactgtagcatctgatgttcacggctaatttgtgcggcatgcgacaacacatccagaaatattcatcggtagt	acagtaccacacaacgtcggtgggcagcagcaacagcagcgggtggccagaaagagcatcagcgagatgaaaaggggaatcgtaattctgaaacggcgtcatgaccttggcatgccagtctcgcttcttcctctttgctatttcgcagctagcctgtccatcgtctctgttcgtcgtacacaccctcgatgcctctcacc	rev-3
tcggcgtgtaagtataactgggaaatcgatttaaaacgttaccaacacacaaactacctaaaaattttcagaagcgagctagttgatttacgggatacagacttccgccttgttgggatcacaagttatggcatggttaacacttatgtttccgttcttgtatctgcaaactgtcctatggatgtttacaagtttccatt	tgacagtgatcaatgagttgcggaggtgtgcatctccagttttgaaacggaagcaaacgaagttaaggtcagtttgtaccttaatagacttttctacatagggttatttaatttcagcagaaaactagagtcttttatcgggacaccgctcgagtacacctgcgccgcaattctcgaactactgacatttgccaattttg	rev-3
cagagactcacgtgattcaaatagattcgatgccagaataccaaaacaaggtcagaaaaacaaggtacagaagtgaaaaacgaaacaaaaaatttggttttgcccacgggacgcgtgttatcagtttcaattttttttctggagcaaatgttttctaacttcaaagtaatgttgaaattaaaaaaagagtgcaggttgtt	agttggtgtcctgttaaaacatattttttgtaagtttggtctcaaactcaaacaaatactttcttgaggataacaaattgaatggtcaaggtatcatcagttccaacacagctggtgcgaagaacaataacatcttccttaaaataatattatatactcatatttttacccccgttcgaagcatacctcgtcaacacgga	rev-3
