tgactggacaatcaaacaaccatcacaggagtgaaatgacgagaaaacagaacaatttgtggaagacaaaaaacgtgggttcaataagaaaagaaaagtgattatttcaaaaaaaaaaagttggggtgcaaaatagagcaatcatcagaaagtaaagaaaatgagctcttgcgtgctcattcattctaatctagaatatt	gactggacaatcaaacaaccatcacaggagtgaaatgacgagaaaacagaacaatttgtggaagacaaaaaacgtgggttcaataagaaaagaaaagtgattatttcaaaaaaaaaaagttggggtgcaaaatagagcaatcatcagaaagtaaagaaaatgagctcttgcgtgctcattcattctaatctagaatattg	rev-1Splice
gtccgaaagatgaaagtctgaaggttgacaagttcagacaacatttggcaattagtcatgggaagccagaaaaaatgtaaatattattcagaaagagcggttttttttatgggctgcacccaataaaaatccaaaaaaaaaaaccccaaaaaatgccaaaatttgcatgttttgtgcctattttaggcctgcctgcctta	tccgaaagatgaaagtctgaaggttgacaagttcagacaacatttggcaattagtcatgggaagccagaaaaaatgtaaatattattcagaaagagcggttttttttatgggctgcacccaataaaaatccaaaaaaaaaaaccccaaaaaatgccaaaatttgcatgttttgtgcctattttaggcctgcctgccttac	rev-1Splice
agtggcttatcagaaacgaatcttaaacaaatattatcgtttgctccagactttcaatcgtggcgaaaggctttttttgagtctctttgcatcttgaccgcccccccccccccctttattgtttcgatttcatcgagatacccgcctgttcgtcaaactctcatttcatttcgttctcaaaattcaactttgtttattca	ggcttatcagaaacgaatcttaaacaaatattatcgtttgctccagactttcaatcgtggcgaaaggctttttttgagtctctttgcatcttgaccgcccccccccccccctttattgtttcgatttcatcgagatacccgcctgttcgtcaaactctcatttcatttcgttctcaaaattcaactttgtttattcacac	rev-1Splice
gcttttgaagataattggcgtgcaacaattttaagaacatttttctgaaaaaaaattgcaagaaaaatttgaaaaaattatacatagaatatcgaggagttaataagtagtggtgtaagtcgttgtgtgaatcgtcgaagccggacgattgtactgttgatgaacatgtcggcttgtagatgtggattgatgtagacctg	tttgaagataattggcgtgcaacaattttaagaacatttttctgaaaaaaaattgcaagaaaaatttgaaaaaattatacatagaatatcgaggagttaataagtagtggtgtaagtcgttgtgtgaatcgtcgaagccggacgattgtactgttgatgaacatgtcggcttgtagatgtggattgatgtagacctggag	rev-1Splice
tcccccgaaattctcaatatgtaatgaattattatttcttcgcaattattttttgccgcttactgtatgaaagtgaaaggaaaattagaaaattagtgatggggggggggggggggtgataagagaaatctgggttgaagggggaggggtagggcgataaaaagggaaattttaggaggaagagaagctggtttttaaaa	ccgaaattctcaatatgtaatgaattattatttcttcgcaattattttttgccgcttactgtatgaaagtgaaaggaaaattagaaaattagtgatggggggggggggggggtgataagagaaatctgggttgaagggggaggggtagggcgataaaaagggaaattttaggaggaagagaagctggtttttaaaaaata	rev-1Splice
tatacaaagtgatgatttaaatccaaatagcgacaaaaattggaccatttccatgagatttttgagttgttgaaatgatgaaaatattttcagaatcagtttaaaactatgaaacaaatgtacaatttttaattttttcagagttgggaagttttctgtttctgttcagatattatgattacttttcaagtttgtttcat	agtgatgatttaaatccaaatagcgacaaaaattggaccatttccatgagatttttgagttgttgaaatgatgaaaatattttcagaatcagtttaaaactatgaaacaaatgtacaatttttaattttttcagagttgggaagttttctgtttctgttcagatattatgattacttttcaagtttgtttcatttttctc	rev-1Splice
tcgcaaattcccttttgccagcgaaaacattccgatctaactgttttccactccagtttcaaggtttgggcttgggcttaggcttaggcttaggttgggtttaggcttaggctgaggcttaggcttagttacatgcttaaactcaggcttaagtttagtcttaggcttaggcttaggattgagcttaagcctagacctaa	cagcgaaaacattccgatctaactgttttccactccagtttcaaggtttgggcttgggcttaggcttaggcttaggttgggtttaggcttaggctgaggcttaggcttagttacatgcttaaactcaggcttaagtttagtcttaggcttaggcttaggattgagcttaagcctagacctaaacctaggctcagtttcag	rev-1Splice
actatctcaatttcaaaatgattattttgatcttcatcactaccttattaacttttctgatagtcagacaaaaccaactatccaaaaaactcccaccgggtcccatagcttttcccataatcggaaatattcctcaagtggcttattatgtctggaagacggagggaatggtgccagcacttgatttatttagaaaggta	ttttctgatagtcagacaaaaccaactatccaaaaaactcccaccgggtcccatagcttttcccataatcggaaatattcctcaagtggcttattatgtctggaagacggagggaatggtgccagcacttgatttatttagaaaggtaatttattttttgattggagttcttagtctataatttgttagacttatggaaa	rev-1Splice
cttaccgggttgttagcaatgaaattgagagtttcacgtgctttggcacgctgccccggagtcactttattggggaaagtggtctcgagaagctttcgtttttcctcgaatgtcatttcttttgtcggaactttgacctccttctcttttctgaaagaaagtttttaacatttttgaactttccagcaatctgtgctaag	gagtcactttattggggaaagtggtctcgagaagctttcgtttttcctcgaatgtcatttcttttgtcggaactttgacctccttctcttttctgaaagaaagtttttaacatttttgaactttccagcaatctgtgctaagtgggtttacggtagtcattgcataggaagtgcgatttttaaatggaattctggatgtt	rev-1Splice
cttgatataagcttcatgcttaaaatagcaacaaatcctgctctttcctgactccattgattttcagcacttccttcaacttgattgtttgtatcttcatcaatttgaacgcgttgtaaagcccactccaaaagtatcagcaaattaccaattccttccgctgtgacatttttcagtgcagcaggtgaaaagagatttga	gcacttccttcaacttgattgtttgtatcttcatcaatttgaacgcgttgtaaagcccactccaaaagtatcagcaaattaccaattccttccgctgtgacatttttcagtgcagcaggtgaaaagagatttgacatgtctctactgattgacagctgtttattcgaatccgattcgtcacgactttcagatccaccgac	rev-1Splice
cttgatataagcttcatgcttaaaatagcaacaaatcctgctctttcctgactccattgattttcagcacttccttcaacttgattgtttgtatcttcatcaatttgaacgcgttgtaaagcccactccaaaagtatcagcaaattaccaattccttccgctgtgacatttttcagtgcagcaggtgaaaagagatttga	gcacttccttcaacttgattgtttgtatcttcatcaatttgaacgcgttgtaaagcccactccaaaagtatcagcaaattaccaattccttccgctgtgacatttttcagtgcagcaggtgaaaagagatttgacatgtctctactgattgacagctgtttattcgaatccgattcgtcacgactttcagatccaccgac	rev-1Splice
gcgagacccgctgcgtccctctgcccgtagagctgcccgtcggagagacgggcggccgtcgttctgtgcttcgctgcagatttgtttcgcacaaaaatcactggttttcactatttttacgctatttttttggttttttcttaattttcaggcacaaatatcgaatttaagaaggattagctcataaaaatcaagtttac	tttgtttcgcacaaaaatcactggttttcactatttttacgctatttttttggttttttcttaattttcaggcacaaatatcgaatttaagaaggattagctcataaaaatcaagtttacgagcaggctttccctaaatttagttgaaattgggcctggaagttattaattcttcatgatttttctctttttgtttgatc	rev-1Splice
aaactaaaaagtggatacgtttatccaagtaaaacattttataaccaatttggtctgttcaaacctccttttcgaatttatgagtttcaacttttacaagatctgggatgttcaaaagaccgttatgctattttccaaattatatttttacaagaaagcatcaaatattataaaattatgtttgtttctactgtattatc	ttttacaagatctgggatgttcaaaagaccgttatgctattttccaaattatatttttacaagaaagcatcaaatattataaaattatgtttgtttctactgtattatctttgtttttcatatggttccaagttgtctaccaagaaaaaagatttgaacttttgatcaaaaaacttaaagttttaggaagttagtttgta	rev-1Splice
aagttttgatactctctcctgggaccccctatcattgtgtgctcttatatctctgcaaggaaagcctctaaactttatgtacccaacagcgaatgtcccatccgaaacaatcagcttatgtagatgcgcacgcgtgcactcgaatagtcaacattaacaggggttaggatgaaaagaaaaagaagaaagagaagagcaac	cgaaacaatcagcttatgtagatgcgcacgcgtgcactcgaatagtcaacattaacaggggttaggatgaaaagaaaaagaagaaagagaagagcaactggtaggagatgagaagagcccataaatatttgataggttccgcatagtttctatgatgtttcaaaatgtatagaggacttcttgtcaactatttcggagct	rev-1Splice
ctgtaacattggcacacaattttcttttttcaaatacgttgataaagtgttccactttcacagttttttacagttccagataaatatcattattcaaaaactatgactaacatcccactatctatttttcagattgtggtcacaatctatgtaggagctgcatcaacaaactcactggcaacggaatcgtcaagtgtcca	atctatttttcagattgtggtcacaatctatgtaggagctgcatcaacaaactcactggcaacggaatcgtcaagtgtccatttgaccgtttggatacgcgcgtcagagtgactggtcttccaagaaatttggcgcttatcaatttgtaatctgaattatttttatccactcttcctcatgatttctcaaaaacttcagt	rev-1Splice
tatcagaacacgctggcgccttcgtagtcgacctagttgtgcagaatccgcaagtttttgggcattgatcatgcatcatctttctgtaatttggatccgtacacaaatttcgtcgcattgcacaatcgctaactcctgtcgcattgtttattttgtcatggcatggatcagaggtagtggatgttgatggggaaagtgtg	tcctgtcgcattgtttattttgtcatggcatggatcagaggtagtggatgttgatggggaaagtgtggtgccattgcccgatatgactggaagcaaaaattttttagtgtggtaggtatatgtttcgcagtgcccgaaacattttgggttccgctgtgcagacggtgcgtcatgaagttggcggagggtcgctgcaagcc	rev-1Splice
accataaacaagggaaggttctaaaaggttggttactgacgatcaatctgaaaacgtttttcaaattttttcacctatcacatgtgggtgtattgcagtgctgtgcggctctcggcgagagccgaaaaaaattttgactcggctctcggcgcgagccgagagtcgacttttttcaagagccgcacagcactggtgtattg	ccgagagtcgacttttttcaagagccgcacagcactggtgtattgccttaaagaaggagtatcgtcaatggggaaattgttttaaaatgtagtatttgtactcaaacttccaattattgcaaaagaaaaacggaaaaaatccgttaacattgaccatttagccgctgaaatcgacgaaagtggctgaaagtggctgaatt	rev-1Splice
atagcttagttgcataacaatatccgcttgacaattccacaaagtgtttgccgaatcttcattacatgataaattgattttcaatttatccgattttcgagtataagtttcctgaatacaagattattttcaaaaaatatcaacaccaactttaacttaccatggcagattgataactgtgccaactgaagagctgattt	gcagattgataactgtgccaactgaagagctgatttttttgaaatcttttacgctttcaatgatcagtttaatttctccacaattgatatcttccttcattttcttttgcgagttcattgtgtatttcttacttctatagaatggagatcttccaaaattggcaaaacttgaaatgaggctgttttcaacatttttcgtg	rev-1Splice
actgtaaggttcctgtagctcgggaaaatttgaattttcagcttttttagaggtactcggttgggagttggtggaggataaagtcaaggtactgtagtgggtccgcaagggatactgtaaaattactgtaaggttcctgtagctcgggaaaatttgaattttcagcttttgaagaggtttttttgttattttgttgtcag	aggtttttttgttattttgttgtcagtttggaatcttagcctgactcgagtgcacttttccaaaaaaaaaactcgctgtcaataacaagtagttttttaatcaacaatgtgaattatgacttgtcagcttagattaaaaattttcacaagctaacaaccagttccccttccaaaaaatcgccaagtactgtatcaaaaaa	rev-1Splice
atccaggctggtaccttaattgaactaaagtttcaaataagttttatattatttaaggctgacggtaagtgatatttgacgttttaactggcagttctttttaagcttgtctccaccattatcaaggtttttctataagttgagcggtgactcagatgaaattagatattcatagtcgctattttctcacgtctaactta	aacttatactgataagcccatttgcaaataagatacgcagatccctaaaaatcacatgctcacacctcttgaatgtgtccccatcatgagcccctgtcagttgcacctgcctcttaccgagagctctctaccactcaagcttcacgccttcttgtcattcaaaatgttttgttttcttgaatagaagatgtcactgaatg	rev-1Splice
aatcttcgaagatacatcttgtgagcaaataataatgtttatcgacaataagcaaagcttcacttttaatttccaagcaaatcattccaccttatcctttttcaattcaactagcaattagtaatatcttgaacaacagcagctggcggcttgctgattcctctttttccttgatttctctttaaaaaacgacacctagc	atatccaatctggcttcttaagaaataagaaagcatcagttccaattatgcgctgtgcttagtgaactggaaaaaacagcggcatgcgaaacctacccaggcgagcccgaacaagtagagctgctgaaaattatcggttttgtggggttgcaaattttcagataaacttttgttttggaatatatatatatataaatttt	rev-1Splice
tccagcttctaacagaggagaaaccaaatatgttgctttgccaaaaacggtaatcctgccattctgctaaatttcatattttgtatttttagaacgaactcttgactatggttactctgggaattgggcatgatgtaggtgcagaggttaaactgaaagaggtaattgatgaatgccacgcataccataaaaacagtttc	tctttatgagaatacattaggaggaaaatatttccaatatgctgtcagcggagaaagtggaatgcaacgctcaagtgtatatgaaagtaagccaaatggttatccataaaattaatcgataacttgcagaggatcgataccaggacagagtgacaaagcacgtcaaggctgattatttctttaaaaacattcttcataaa	rev-1Splice
aacctactgacattttttttacagagtgatagcttcaaaattgaagttactaggtcaaaaaaacgcaaaaaaggccgtacaacttctatacgccaccctgagatttttgttgaaaatcagtgatattgccaaattatcaaccttttcaggaccaacttttttaattgttctccaattttcgagtacccgtgtatatttca	gccctccaaaaattctgaaatttttttcagtgctaaaggagaatgcttacatttcatactataactgccaaagttgtaggttctgtttaaataattctgtaatttgttttgtgttaggtttgaaaatacggtaacagttattttggagaacttggactagttactgtagtttgggaaaaattgacttttcgccttttgaa	rev-1Splice
gaaaatttccggcaaatcggcaattgattctcagtgcaacaaaaggctcactttattaataatctgctagaggaaaatttccaattaaaacacttttttcaatttcaatttccaatatttcagacttgccccaccaaagtacactgtgttcaaaagattaacatatctaatttgcgaagaagcgtacgaacccgagcttc	gttttttgcagagatttcttgacaattttcagccgacgacatccccgaattaaacccctatttcatttgaaagaggatcttcgaattaggttcctacaaaaattttagccacaaagaagaattttgaactggcaaacagtcgatttgaatttttttttcatttaattttttgcaactttatttcactaggcttgaaaaat	rev-1Splice
