agttggttttttgggggagaagcgggacaatggagtgaatggagtgaacagcttctttccaatgctttccaatgctgaaaagttggtgatcaagtttaaattttttttactttggtaacagggccttttaagtatttagtatttattgacgaataagtttttttggctaaaaaattttaactttattcaaaaaaaatttt	gttggttttttgggggagaagcgggacaatggagtgaatggagtgaacagcttctttccaatgctttccaatgctgaaaagttggtgatcaagtttaaattttttttactttggtaacagggccttttaagtatttagtatttattgacgaataagtttttttggctaaaaaattttaactttattcaaaaaaaatttta	RevEtaKappa
tgaattattaattttcaatttcttcattaactttccgcccttgttttcgttttttcttcgaaattttccgcatttctgcgtttgaatccgtaattcactgtttttttttccgtcttcccacacagtttttctcaggaatttcagttattttcagacaagttttcttttcagaaaatttcataatccccctctctttgact	gaattattaattttcaatttcttcattaactttccgcccttgttttcgttttttcttcgaaattttccgcatttctgcgtttgaatccgtaattcactgtttttttttccgtcttcccacacagtttttctcaggaatttcagttattttcagacaagttttcttttcagaaaatttcataatccccctctctttgactc	RevEtaKappa
tttcaaaattaacgaagatattacgttttgaagtgaagtagtgcaatgcaatactatttgaggaaacgcggaactcataggatggggaggaaaataacggaaaaaatacgattctcattaaaaaattttttggaataattaccttgatattacatataatctttaatttatttgaaatacttctaaggcaaaattcacaa	ttcaaaattaacgaagatattacgttttgaagtgaagtagtgcaatgcaatactatttgaggaaacgcggaactcataggatggggaggaaaataacggaaaaaatacgattctcattaaaaaattttttggaataattaccttgatattacatataatctttaatttatttgaaatacttctaaggcaaaattcacaaa	RevEtaKappa
cagatctgaaatagaaggaattgttgagtttcacactcaaaacatcaagaaaattatttttattttcccccagcttacagtaatcatcagttctgccatattttttttacacaatctggatggagtcgtgatgtcagccccgctcatatccttatcatgaaccattccatccgatgttcgtacaacttctgtatttccat	agatctgaaatagaaggaattgttgagtttcacactcaaaacatcaagaaaattatttttattttcccccagcttacagtaatcatcagttctgccatattttttttacacaatctggatggagtcgtgatgtcagccccgctcatatccttatcatgaaccattccatccgatgttcgtacaacttctgtatttccatc	RevEtaKappa
ttttaaatgaattttgaactgaaaatctgcgaaattcgatggtggttatagttttaaagctatagtaatatgaaatggtgaaattttcactcaaaaattgcccaaatttgaggattttaagatattgtacgtgaaaacacccttaaaaggaagaaatttggtggaaaaatacaattttcgctctaaaaaattccgtaaat	tttaaatgaattttgaactgaaaatctgcgaaattcgatggtggttatagttttaaagctatagtaatatgaaatggtgaaattttcactcaaaaattgcccaaatttgaggattttaagatattgtacgtgaaaacacccttaaaaggaagaaatttggtggaaaaatacaattttcgctctaaaaaattccgtaaatt	RevEtaKappa
gagtagtgtaaaattagcgcaaataaggagaattcgggtgaaattagtcatttcgttgcaggtacgaggatgaggaacagattgttatcttgaaatgcgactatgtgatttccgcatttggatccacgttgaaagaagacgcaggtgtgttgagcggttttttttcttaagaactaaccgagagctgactttgaagatta	agtagtgtaaaattagcgcaaataaggagaattcgggtgaaattagtcatttcgttgcaggtacgaggatgaggaacagattgttatcttgaaatgcgactatgtgatttccgcatttggatccacgttgaaagaagacgcaggtgtgttgagcggttttttttcttaagaactaaccgagagctgactttgaagattac	RevEtaKappa
ctcgattaaaatgtttttagaaattttgcgttaaactttagtgtcacagcaaaaactttttttttcagagacgcaggaagtaaaatcaacatttcgaaacattgcgaaatatttatttttcacatactactttatcaattttaaaatacataacacccatagcaactttaaaatttatattgtcaactcaaacaaagccc	cgattaaaatgtttttagaaattttgcgttaaactttagtgtcacagcaaaaactttttttttcagagacgcaggaagtaaaatcaacatttcgaaacattgcgaaatatttatttttcacatactactttatcaattttaaaatacataacacccatagcaactttaaaatttatattgtcaactcaaacaaagcccgc	RevEtaKappa
cactctttgtggactactatgtcgaaaaaacatgtttaataatgagcaaaacaatttaaattttattttaatttaaatttgtttatgttgatgaaaaaacatatcaatttcttcaaaatagttaaatttttgagctgtgtttcgaaaagtcgcaatctttcttttccaaatatcagaaaaacgaaaaacgacaattttcg	ctctttgtggactactatgtcgaaaaaacatgtttaataatgagcaaaacaatttaaattttattttaatttaaatttgtttatgttgatgaaaaaacatatcaatttcttcaaaatagttaaatttttgagctgtgtttcgaaaagtcgcaatctttcttttccaaatatcagaaaaacgaaaaacgacaattttcgat	RevEtaKappa
tgattcactcattgatttatagacttaaatttgcaattcctccagatgcgaaatacaaaacattggtgaaagttgcagctgatgttctgaacgcgttcttttacttaacatcggttctttgtacatgtgccattggatatatgaacgaggatcaaaagtttgcaaagaatagaataattgaggttagaaacactataaca	tcactcattgatttatagacttaaatttgcaattcctccagatgcgaaatacaaaacattggtgaaagttgcagctgatgttctgaacgcgttcttttacttaacatcggttctttgtacatgtgccattggatatatgaacgaggatcaaaagtttgcaaagaatagaataattgaggttagaaacactataacaaggg	RevEtaKappa
ttcaatttaaaaacgaacggcattagcagtttttcgaaaaaattttcggaagttcctcaaaccttcaaattagggggggtcctatagaactttcccacactgtatgcatcgcaaaatcgattttgtgacggttttcgagatagtggccaatataggttttcagactgagtatcatgaaccaatccatctagtttctgtgc	atttaaaaacgaacggcattagcagtttttcgaaaaaattttcggaagttcctcaaaccttcaaattagggggggtcctatagaactttcccacactgtatgcatcgcaaaatcgattttgtgacggttttcgagatagtggccaatataggttttcagactgagtatcatgaaccaatccatctagtttctgtgctacc	RevEtaKappa
tttctacaaaaacaatgataaggttatataacacgtcctcagcccattctttctgttatttattattcccactctattcaatataatttttattttttcctctttttatctcatttttcatgttcaaaaaaaaattttgaataataatgataatattagttaggacataacaaacggctttcgcattttattaaatttca	aaaacaatgataaggttatataacacgtcctcagcccattctttctgttatttattattcccactctattcaatataatttttattttttcctctttttatctcatttttcatgttcaaaaaaaaattttgaataataatgataatattagttaggacataacaaacggctttcgcattttattaaatttcaattttctt	RevEtaKappa
catgaatttctagattttcatattcataaaaataatataatacatctacattttccacagtactacatgacttttcgcgatgctacccaaatttttgaaatttggaaatttttcaaaaattctcaaattttaaaaatcccataattcagccaatttttgagattttcagatattttttaattgaaaattctgtttgtctt	attttcatattcataaaaataatataatacatctacattttccacagtactacatgacttttcgcgatgctacccaaatttttgaaatttggaaatttttcaaaaattctcaaattttaaaaatcccataattcagccaatttttgagattttcagatattttttaattgaaaattctgtttgtcttatccattaaacta	RevEtaKappa
gtactatttcgccaaatgttgataagaatgcagccgcaacagccttccaaaatttttcaaccctcatgaatataattcttgaaccttgggagaacttcaaaaatctcgagcaggaggattttacgacggtatttaaatctgtcaacaagaaactggaagtttataaaaaggtcgatctaacacgtgtgtccgcgactcaa	aacagccttccaaaatttttcaaccctcatgaatataattcttgaaccttgggagaacttcaaaaatctcgagcaggaggattttacgacggtatttaaatctgtcaacaagaaactggaagtttataaaaaggtcgatctaacacgtgtgtccgcgactcaagtcggtacaggagtggcgatatcaccattcttctcga	RevEtaKappa
tttttgataaatttggggtcatttgagaaatacagaacaatttcgcatgtttgaacctttaaaaaattttttggaaatttgccaaaatattgataagtttccaaattctttatgaaaaatttagagcattattgcatttcacccatgttttgtaaagctgattcaaaaatacaaaacaagttcaattctttctgtgttat	tcgcatgtttgaacctttaaaaaattttttggaaatttgccaaaatattgataagtttccaaattctttatgaaaaatttagagcattattgcatttcacccatgttttgtaaagctgattcaaaaatacaaaacaagttcaattctttctgtgttattggaagctgtaaaaacctctatcattttgctctgtaaaattc	RevEtaKappa
acaaaaaagtttaagcaatgatctacagaagttctctttcatggctttgcaattatgtttcataaccctaatgtctacagtaatcaaacatctatggtaactgttacagaatttgaacacaaaatgcaattttagaatacagtaagcctttagtaaccgtataacataatctacagtacactacacttataatttaatca	ttgcaattatgtttcataaccctaatgtctacagtaatcaaacatctatggtaactgttacagaatttgaacacaaaatgcaattttagaatacagtaagcctttagtaaccgtataacataatctacagtacactacacttataatttaatcaccaataattaaatgaaacattcaatattttctcaaattttcaataa	RevEtaKappa
atattcaacaccaaatgcaacaatctcgacaaccatcaggttatcatccagctgtaaatggagttgtaaacctgaatggagtcaatggaaataatggaaataccgagtataatgttcaaccatatcagggaactggaaatcagcaaacacaaaatggacaatcgatttctccagagatgaggagacaggcggtttgtaca	cagctgtaaatggagttgtaaacctgaatggagtcaatggaaataatggaaataccgagtataatgttcaaccatatcagggaactggaaatcagcaaacacaaaatggacaatcgatttctccagagatgaggagacaggcggtttgtacacaaatcaataaaaaatccaataataaattgattttcagccatacagct	RevEtaKappa
cagttaggctttttcttgttttatcattattctttgtcatcatcatcatcaccttcacataacattatctgttaatttacgtacgtgtttttcagcacttgacacatgtatttattttaattaatttgtatcttttcagccaattaagaatttctcacaataaaaagattcataaaacatttaaattatttcctcccaaa	tcaccttcacataacattatctgttaatttacgtacgtgtttttcagcacttgacacatgtatttattttaattaatttgtatcttttcagccaattaagaatttctcacaataaaaagattcataaaacatttaaattatttcctcccaaagtatgaacttcttttcagagcaccttttcatgtgacattggtagattt	RevEtaKappa
attggcttcacagagaattttggatttctggcccaaattaggccgattcaggcctggtttgacccgaaaacgggccacgccgatatgggtgtcaaattttgcgtagaattcaattttaatactaacaaatcttagtgaatgcgttttttgtctaaaattgtccgtttcagtccgtttttcgtgaaattttcttcaaaaat	aggcctggtttgacccgaaaacgggccacgccgatatgggtgtcaaattttgcgtagaattcaattttaatactaacaaatcttagtgaatgcgttttttgtctaaaattgtccgtttcagtccgtttttcgtgaaattttcttcaaaaatttcagaatttttttttcaaaaaccaaaaattatagtcacaaaccacacc	RevEtaKappa
tacacaagacgaatattgttacatcttcacagtggctgaagttttcgataggtatctcaacaacgatacaatcaagttgaattttctttgcattcttccaatgatccattaccacaatatttttaaaaccgaatggcttacccaaataagcgatggtcaattctgttaatttgtctggattgaagtatgttaatacggaa	tatctcaacaacgatacaatcaagttgaattttctttgcattcttccaatgatccattaccacaatatttttaaaaccgaatggcttacccaaataagcgatggtcaattctgttaatttgtctggattgaagtatgttaatacggaacacagttgagagagattttctatttgcaaatggagtgagcgtacataaattg	RevEtaKappa
tctccttctatcttatcatacctatctatttctcgctatcgaagctgtccaatgcctttgctttatccatttcgcgtacccggagcacaaaactcctcaagctgctctcagtgagttcttcgcagatcctcttcaaattgttgggaccattttgcttgcgggtgttggagcgtttttgctcgatcggttatttttcaaca	cctttgctttatccatttcgcgtacccggagcacaaaactcctcaagctgctctcagtgagttcttcgcagatcctcttcaaattgttgggaccattttgcttgcgggtgttggagcgtttttgctcgatcggttatttttcaacagaaagcagtatacaattagaagcttctgtgcaaagcggtatctgatggcaacag	RevEtaKappa
tgtgatagctcgttaacaagagccgccatatacatacacacacaaaaagagacatcaaggatgtttggtggtggtggtggtagaggagtagaggagaagaagaccccaaacgagtttccgaagtcggttccggtgtttagaagaaggctaccgtagtcgggttgaattgtaaatgaaccattgttggaacactagaagtt	tcaaggatgtttggtggtggtggtggtagaggagtagaggagaagaagaccccaaacgagtttccgaagtcggttccggtgtttagaagaaggctaccgtagtcgggttgaattgtaaatgaaccattgttggaacactagaagttcgggtacacgcgattcaagttccgttcggttttgagtgagtacggagtgagtaa	RevEtaKappa
attttcgaaaactttctaaatgtggtttagcaaaatctaaaacttttctttttcagaccaaaagtagcacagaaataccgaattccaaacttgccatattttgagctaaaatcctaaatttcatctctttatcaatatcacaatttgcggaagagttttgataattttgatttgatgcttttccgacgataagtgcataa	gaccaaaagtagcacagaaataccgaattccaaacttgccatattttgagctaaaatcctaaatttcatctctttatcaatatcacaatttgcggaagagttttgataattttgatttgatgcttttccgacgataagtgcataaaatatacatttttccaaaatgttgagaagtcaaaacttttcttcagaagttttca	RevEtaKappa
accattaaaagccagaatgcagaacttaggcgatgaggcaggtaaatgctagtgcctgaaagcgcgcctgcctactatgaaaaaaaatgccaaaaacaaagcaccctgccgaatcccattaaaaagtgttgtagggggaaatgcaaataaatgtaccgcctggtaaaggacgattggcaaggaaaattgatcaggaaaca	gaaagcgcgcctgcctactatgaaaaaaaatgccaaaaacaaagcaccctgccgaatcccattaaaaagtgttgtagggggaaatgcaaataaatgtaccgcctggtaaaggacgattggcaaggaaaattgatcaggaaacaaggggagcttttttttctgaaaaatgtcgaaaatgtgactcagaattttgtttacca	RevEtaKappa
gaacaacactgaactacataatgtagtctctcacttcctgtttatatggggtgattcgcaaactccttgtatatactcatcattttgttagtcaactcattccgttctcacgatatggactactttcttgatgcttctaaacatattcagttgaatcaaattgatgaagaatcttcagatgattgtaagtaagttttata	caaactccttgtatatactcatcattttgttagtcaactcattccgttctcacgatatggactactttcttgatgcttctaaacatattcagttgaatcaaattgatgaagaatcttcagatgattgtaagtaagttttataacggacacatcaagcgacattgaaagaaagtcaacttttaaaatatcgactttcatgc	RevEtaKappa
tttcaattcggctgaaaataatgataatacttgaaactatcacaaatttttaaattacaagtttctaaacgaaaatctaaaatctcaaccaaaaaaaaatttcggtgaaacaaaaaatcctcaaaaacaactacacttttccccacattcctgtacggcgctatttgttttcccttcacatatattctcaccaatcacca	aagtttctaaacgaaaatctaaaatctcaaccaaaaaaaaatttcggtgaaacaaaaaatcctcaaaaacaactacacttttccccacattcctgtacggcgctatttgttttcccttcacatatattctcaccaatcaccatggatacttgtggaggtactttcagagcttacaatgctctgagctccccagctttccc	RevEtaKappa
atagtcaatggaaatatatcttaactatagttatgaaaatatgacaacgaaaaaatctgaacacacaattattaaagcctgacaccgaagacatcaggaggcacttccataaattttttgccgtgttccttacgatatttgaactgaaatttaagtaaagttttcaagggttatgaagtatttacagtatctgttagtat	aacacacaattattaaagcctgacaccgaagacatcaggaggcacttccataaattttttgccgtgttccttacgatatttgaactgaaatttaagtaaagttttcaagggttatgaagtatttacagtatctgttagtattcatccaaaacgcgacaatcagtaaaagtccatatgaggtaaaaaagagaagaaccttt	RevEtaKappa
actacaaattggcccaaaaactttgctgaagactgttcgatggataaatgcaggtgagtagggaaaatttggtgaattttcagaaattgcgcgaaaaatagaggccattctctgatattttctaattttccaattgcaaaataatggattttagctattttttcaccaaaagtacggtattacgggaacaataaatcatg	agggaaaatttggtgaattttcagaaattgcgcgaaaaatagaggccattctctgatattttctaattttccaattgcaaaataatggattttagctattttttcaccaaaagtacggtattacgggaacaataaatcatgagaatgcgtacgtggagcattttatttgacgcgcgatatctcttagcgaaaactagagt	RevEtaKappa
ataattgaattgttacactgaactccatttgttgtagaaggaaaagtgccaattgacttgaggttatgtcgaaagcaagggtcaatgaaaggagaattgaataaccttgaaaaagtgtaaatttggttaatggcttcaaacggaaaatttaaacttcccgtcacaacaattttttctttttttttcagattattcaaatt	aggttatgtcgaaagcaagggtcaatgaaaggagaattgaataaccttgaaaaagtgtaaatttggttaatggcttcaaacggaaaatttaaacttcccgtcacaacaattttttctttttttttcagattattcaaatttccagcctaaatgttttctgaaaacttgaatttcccgccaaattttattccctagaaaat	RevEtaKappa
aaaacaagccactgaatgcaggggaagatgatggggacaaaaaacagagttttccggtagcagagtgtaatgagaaattcagcaagctgctcaagccgatcttcaatgatattctcacagatgacaatcaggtttcgagaaccagcttgttgaaattcaaaattttccaattttcaattttcagtccatcatctacggcg	cagagtgtaatgagaaattcagcaagctgctcaagccgatcttcaatgatattctcacagatgacaatcaggtttcgagaaccagcttgttgaaattcaaaattttccaattttcaattttcagtccatcatctacggcggactatccacaaatgacaatttcactcgatatcttcaattttcccgagaactgaaccatg	RevEtaKappa
ttggttgtcactcatgccggaatccgtggagctgtctgcttcggtctcgttcagattattgacgaaagaatcatcccagccaagccgtactttgtcactaccacccttgccatgatcttcgttacatctattcttcaggtagaaaatcaaccagtgtagagtgataattgtttttgattccagggttgtaccattaagtt	acgaaagaatcatcccagccaagccgtactttgtcactaccacccttgccatgatcttcgttacatctattcttcaggtagaaaatcaaccagtgtagagtgataattgtttttgattccagggttgtaccattaagttcgtcatgaaatgtctcaagattccgggtgacgatggaacaaaacagaaggatccaaaagcc	RevEtaKappa
acgacaacgaaaaaacttataatttccgtttaaatttgtatcaaattgaaacctccgtcactatcttcatcgaaacaatcccaatttggttcacccctttgctttttcctgccactacaatcatcaatgtatgctcatcaataatcatcctaatcaccagcttaatcacacaatgtcctttcttctcaagcatgccccca	tatcttcatcgaaacaatcccaatttggttcacccctttgctttttcctgccactacaatcatcaatgtatgctcatcaataatcatcctaatcaccagcttaatcacacaatgtcctttcttctcaagcatgcccccattctaaaaaacaaacatcggtggaacagacaagaggatgacccccttccgtcctttccgaa	RevEtaKappa
caaaattgccaattgacagaaatataagtttgatactttttgtagatacagtctaaacatgcatttttgccgagctcggcaaactttaagaacgtgaatttactaaaattcagtgattatggtgctccaaaaataataaaatttatcacaattttccgtgctcggcaaatattgaaaaaaatagattttcgaatatgcca	catttttgccgagctcggcaaactttaagaacgtgaatttactaaaattcagtgattatggtgctccaaaaataataaaatttatcacaattttccgtgctcggcaaatattgaaaaaaatagattttcgaatatgccaagcttggcaaattttgaaatttgccacacaccactatttttcaaacctttcagtgctttat	RevEtaKappa
gtaacaaggcgaatgtaacttaaaagtttgcaaagacattattggttttggtattggtatttgtagttgttcaagttcaaactaactttgtgatcagtgagtccacaattccgagggaaaccactcttgctggtgatggctcagcaaacggtttagcttccgtgttctgcaagaaaaaatttcattttttgtttgaaaat	tagttgttcaagttcaaactaactttgtgatcagtgagtccacaattccgagggaaaccactcttgctggtgatggctcagcaaacggtttagcttccgtgttctgcaagaaaaaatttcattttttgtttgaaaatttcccaagggagatttcaaaacatacataccccaactgcttcatcaaatgagcattttgaaag	RevEtaKappa
gagcattgaatgtgttataggttccgcctttgcatttttctacgcgttcctcaatcactacgtcacactaaaacatttaagaagaccacccaagtagaaaccgaacgttcgttttttttccttttttgcttgcagtttttgggggagagagtgagttttttgggatgatgtgtggagatatccaatatgttttcatttct	acactaaaacatttaagaagaccacccaagtagaaaccgaacgttcgttttttttccttttttgcttgcagtttttgggggagagagtgagttttttgggatgatgtgtggagatatccaatatgttttcatttctctttcagtcatttttctctcattttcaacttactctaaaagatgaaatatgtctgcaattgaca	RevEtaKappa
ggagcaaaatgtaaactatggtaaataatttttggaatggatgtgaatattttgttttcattcatattcgatactgataagattgaaaaaagctacagtgctttaagttttttgaaactcagcaaatttgataacttttgaaatctaaaacgtttgaaatgtttttaaattaaaattccttttcaagagtgagtaattga	attcgatactgataagattgaaaaaagctacagtgctttaagttttttgaaactcagcaaatttgataacttttgaaatctaaaacgtttgaaatgtttttaaattaaaattccttttcaagagtgagtaattgaaaatgtctcacaaacttcaaatccaaaacctttaaaaaactgctacatgtgaaaaatttttagag	RevEtaKappa
cccaatggtcagttagaggacttttcttggcgcaagatatacatactttgtcgttgttttcctctattacagaatgtgttgttctaattttttctttatgtcttacttgaaaatgctgtcaactttgataatccaaaaaaaaattgaagaaaaactgaaacaaagctgaaagttagctgatttaaaacagctgaaatcca	ttacagaatgtgttgttctaattttttctttatgtcttacttgaaaatgctgtcaactttgataatccaaaaaaaaattgaagaaaaactgaaacaaagctgaaagttagctgatttaaaacagctgaaatccataaaaaactcaaaaaaatgccacgcaatggttaagaatgaattaattcttggaacatgtttttttg	RevEtaKappa
ccaacctcatccagctcgttcgaaagtttttcagcagttgctttggagactggaaccagtggattcagctgagtagtctcgccctggccgccgaggtttgcttcctgaaattggaaaacgaatttttaattttattagtaaaacttcagtactgtgataagctcagctctagccaatttctcggcttctccgtccttttc	agctgagtagtctcgccctggccgccgaggtttgcttcctgaaattggaaaacgaatttttaattttattagtaaaacttcagtactgtgataagctcagctctagccaatttctcggcttctccgtccttttcagccatcctgagcaacagtaactgcatcccaatttccatcctttccagcctcacattgtcagtagc	RevEtaKappa
tgtgcttcaaaatattgagcattgaatggaataaaacaccgtttcaattatcaaacaatgatttgcaagaggcaaagccatagaaaatttaagatgatgcaatttgaggccgttccaatacacctctgtcgtctgaatgtgcgggactatcactatctttttcaggagtattcatgtttgtgaccgtgagctcaataact	aagaggcaaagccatagaaaatttaagatgatgcaatttgaggccgttccaatacacctctgtcgtctgaatgtgcgggactatcactatctttttcaggagtattcatgtttgtgaccgtgagctcaataactccgtgcatgccatcattcgtttggtttccgttgttttctgcctaaaaattcaaagtttcagagttt	RevEtaKappa
acaagagagatagtgtggttagtggggagacgcagagaacgcgcgatgcctgcgtctccgctcaccccacactcttatacttcgcgatcttaaaaccttgctatctctgcagaaaatgaagctatcaaaactttttcaactaacaagatattcgaaattttcagctctaaaagtttttaagtttttcaaaattactaacc	ccacactcttatacttcgcgatcttaaaaccttgctatctctgcagaaaatgaagctatcaaaactttttcaactaacaagatattcgaaattttcagctctaaaagtttttaagtttttcaaaattactaacctcagtttttccttcgggaagcataaaatcataagatggctgatcaaacttgtcaggaaccgaattt	RevEtaKappa
ttattcctgaaaatttaagtttctcgcaaaaaatgtttttcatataacatttttcttgaataaagcgtggaaaaatgttttaatttctaatccggccccgcccataaactggcaatttttgtctgctttttttcttcattttcagaggaaaagaatctttcaggaataagtcaagttccatagctcaaccttatttttct	gtggaaaaatgttttaatttctaatccggccccgcccataaactggcaatttttgtctgctttttttcttcattttcagaggaaaagaatctttcaggaataagtcaagttccatagctcaaccttatttttctagttcttaccctttttcctgccaatcaccagacttggttattagtttttttttctttggtagacct	RevEtaKappa
tacaaaccacaaaccaataccctttcaaaagacgaaaagtcaatttttctataactacagtaatcctacagtactcctgtagtacctctacaatacagtacccctacggtaccattacagtacccctatagtttctctacaatactgctacagtactctgaccgtatccccctaccaaccctaaaccgatatcccttcaa	acagtactcctgtagtacctctacaatacagtacccctacggtaccattacagtacccctatagtttctctacaatactgctacagtactctgaccgtatccccctaccaaccctaaaccgatatcccttcaaaaaacaaagactcgttttttccaaaactacagtaatcctacagtactcctacagtaccactacgtac	RevEtaKappa
gggcaatagatttcaaaaccaccatcgactccacaagcaccacaaaaaaagagacgagtggtccttccgcctactcacatgatgtatgatgtcatttttgggaacaagatctaattgcagacgctgtcatccaagtgccattcattggaaaaagagaacagcagaacaaaaatggaacgtcacgcacgtaatgaggtaaa	cgcctactcacatgatgtatgatgtcatttttgggaacaagatctaattgcagacgctgtcatccaagtgccattcattggaaaaagagaacagcagaacaaaaatggaacgtcacgcacgtaatgaggtaaaatgaaacaatgaactcatgtgaagagctaatgaaaacagtttctcaaaaaatcctctaaccccactc	RevEtaKappa
atagaaaaaaaatagaaaaaaggaaacgacaagattggtcccactcatctttccttcccggctcctccttcttccaatcaacaggaaattgggctgtgagccgggaggaagaagaagaaaacggcggaaggaagtccgaaacgagtgtacccattacgttttataccctacacggcgcctagatagactccgcccactat	cttcttccaatcaacaggaaattgggctgtgagccgggaggaagaagaagaaaacggcggaaggaagtccgaaacgagtgtacccattacgttttataccctacacggcgcctagatagactccgcccactattttccgactcggttccgggatcaaaatgttacctccgatgaagacaaaatgacctgttgaactgatg	RevEtaKappa
acataatatatgattcatcagtttggaactttattaaattactcagttaactcagttactgcggcctacaagaaactggtaacttggagcatctcagaatcattagtctaataatggtagaagtggtgagattagaccgtcgcaacaatttgattatgagtagggtcttatcattttatcaggagttgaaaaagtcgagt	aagaaactggtaacttggagcatctcagaatcattagtctaataatggtagaagtggtgagattagaccgtcgcaacaatttgattatgagtagggtcttatcattttatcaggagttgaaaaagtcgagtttatgtcgatcgtgacaattaccgctacttcttcccttcgtttcatttttcttaaaaaatttgtaaatt	RevEtaKappa
aaacttcaaatacaacgaactgattttcgaggcgtgcctacctgcctacttaccgcctataaagttctgattgcaaattctgagaactccggaaaccggaaataaaggaattttccaaaaagaataaagtcatataatataaaatttgagtgcacctatttccggtttgaactcactatattcaaactgacgtggttttt	attgcaaattctgagaactccggaaaccggaaataaaggaattttccaaaaagaataaagtcatataatataaaatttgagtgcacctatttccggtttgaactcactatattcaaactgacgtggtttttcatatatggatttgtgctccgaattcaataaagcttctggctggaagatgtccaaagctcactgacgac	RevEtaKappa
aagttggacacacttgatcaagttgctcttgccaagcgattgacaaccttgaagctggagcatagtttcaaaaaagaggatattttcactttggacgccgagacaactgctaacttcgatgataagatcgaggagttattcgaggaatcatcggttccatttgagcaggcaagaatgatcattgagggtacagcttatta	aaaagaggatattttcactttggacgccgagacaactgctaacttcgatgataagatcgaggagttattcgaggaatcatcggttccatttgagcaggcaagaatgatcattgagggtacagcttattatgatgtggaggataagaatggtcaatgggtccgtattttctgcgagtacggggatttgattttgattccag	RevEtaKappa
tcacatgaaattgtatctttgaagttttcaaatctttgttacgagtaaaataatgaacaattcacattctgaaaccactcgcacatcaaataataattagcttcaccgaggatctgatcctgagtttgacaagaaatttaatagaaaatggcatgcccacgagtctgccgattgggtatttctttatgattcggctctaa	aaccactcgcacatcaaataataattagcttcaccgaggatctgatcctgagtttgacaagaaatttaatagaaaatggcatgcccacgagtctgccgattgggtatttctttatgattcggctctaaatttaatagtttgttttaaattattcaaaaaaacatatttaatttttcgataggccagttgtgcaatcaaat	RevEtaKappa
ataatttttgaaatttttcaaacaattttaagctgattaattgattttttaaaaatttgagttaatgcttaaaaaaatgtcacaaaataaaaatatgaggtcaaagtgttggcaatgtaccttaaaaggatttttacttaaaaggattttttaaattgcccgaatagtaaaaacttcgaatttgacatctttaagatatc	aaatgtcacaaaataaaaatatgaggtcaaagtgttggcaatgtaccttaaaaggatttttacttaaaaggattttttaaattgcccgaatagtaaaaacttcgaatttgacatctttaagatatcaataaattaaagatattacctcttaaagtgtgaaaaaaaacgataactttgtcttttaaaacctggtaccgcaa	RevEtaKappa
gagattaggagtcagagtttcaaaacgaacattttttaaattgattttcaaattttcaatagcggaatttcatttttggcaaattgataaattggcaaatcggcaaattgccggaattgaaaatttccgacaaattgcccaattgtcgaagtcgccggaaaaccggcaacgggctttttttttggaaatttcagaatttc	tttggcaaattgataaattggcaaatcggcaaattgccggaattgaaaatttccgacaaattgcccaattgtcgaagtcgccggaaaaccggcaacgggctttttttttggaaatttcagaatttcaattttaatcggcaaaattgtgcgcatcctaagaatctattttaaaaagtaagcaaattctatgaaaatatcta	RevEtaKappa
ttcattaagcaagcaaagagacctacatgttttctaactattatataaatctccttttttcttttttactttcaagattcggtcaccttttttggtatttctgctttcttaaattttatttagttttattcataatgtattcacctaattctcctaaaacattagcggcgcaaaacaaagtgtttatgcaaaacatttca	gattcggtcaccttttttggtatttctgctttcttaaattttatttagttttattcataatgtattcacctaattctcctaaaacattagcggcgcaaaacaaagtgtttatgcaaaacatttcacgaacatggaaacaaattgttgcgataattctttccgcttactctgaaaccggaggtgatgaattttattatagc	RevEtaKappa
taaactgataaacatgcgcttgcaacatttaataatgttttctatacaaaataaactatacttctgattgagttaataataatagttataataataatacaatttctaatttcagactatgttttgtctgtcgcacacaatcagtgccacagcttgtagtttgaacaaggaagtaaatttcgtgtaagcatgtagacagg	ataataatagttataataataatacaatttctaatttcagactatgttttgtctgtcgcacacaatcagtgccacagcttgtagtttgaacaaggaagtaaatttcgtgtaagcatgtagacaggatattgatccgactgtggagagtatcttgaaaaaatctagccgtcacactttccggggatacgaggagattcaaa	RevEtaKappa
aaacatgcgcttgcaacatttaataatgttttctatacaaaataaactatacttctgattgagttaataataatagttataataataatacaatttctaatttcagactatgttttgtctgtcgcacacaatcagtgccacagcttgtagtttgaacaaggaagtaaatttcgtgtaagcatgtagacaggatattgatc	ttataataataatacaatttctaatttcagactatgttttgtctgtcgcacacaatcagtgccacagcttgtagtttgaacaaggaagtaaatttcgtgtaagcatgtagacaggatattgatccgactgtggagagtatcttgaaaaaatctagccgtcacactttccggggatacgaggagattcaaatcgagacttc	RevEtaKappa
tagttgtttctaaccaacaaacaacatagatatttgttcaggaattgagcagaaagaaatggaaaaataacgttctagaagaactgaaatgaaacatataagcatatatatcacagcagaaattaaagttaaacaataggaaacatgaaatgggaaaacagaaagatacaccgacagatcatcagtaataaataattcag	gaagaactgaaatgaaacatataagcatatatatcacagcagaaattaaagttaaacaataggaaacatgaaatgggaaaacagaaagatacaccgacagatcatcagtaataaataattcagccaaataaagaactcatgtgagctcaaaaacttaatgaattacccaaaaaggcggtataaatgagtgtgcgcatgga	RevEtaKappa
ttttgggactcatattttcatctttccttgtgtatttatgcgaaaaaaacacaaatgacaagtatcaaacatttgccgatgctctttggtggggagtggtaagtttttattataatgagcggctaataatagttttcaaattttagattacactttctactgttggatatggtgacaaaactcctgaaacttggcctgga	gatgctctttggtggggagtggtaagtttttattataatgagcggctaataatagttttcaaattttagattacactttctactgttggatatggtgacaaaactcctgaaacttggcctggaaaaataattgccgcattttgcgctcttcttggaatttcattttttgcacttcctgcggttcgaattttgggttcaaa	RevEtaKappa
ggcagtggttgccacgtcagcagccgccgttcttgcactcgacatgaccaacgaacgacgatttcagagacaagttgtgagttttcagaaatgcaaagttttctgaaatatctgtcactttttagaaagatcactttcgaactgtacatgctgatcgacttgcagaactgaataaaagagctccgagtgctctgccaacg	gagttttcagaaatgcaaagttttctgaaatatctgtcactttttagaaagatcactttcgaactgtacatgctgatcgacttgcagaactgaataaaagagctccgagtgctctgccaacgagaaaagatattttgacgaatttgagtgtaagtatcgaaatttctggaacattttcaattaacatttaaaatattttc	RevEtaKappa
ctgaatccgttcattttttcagcgcattctttcgctgtgagaccctcttcgctgaaggagaacacgaatttctcgtccgaatcgtaggcgatcagaagatccggctttttttcttcaattggtggatctgtaggagctgctggagttgttggacgggtgcttcttcgttttggtggagccatttttggaaaatgcctgaa	gaatcgtaggcgatcagaagatccggctttttttcttcaattggtggatctgtaggagctgctggagttgttggacgggtgcttcttcgttttggtggagccatttttggaaaatgcctgaaaatttgaagtttttccggaaaatttgggaaatttacgattaatttcacggaaaattggattttttcaaagttttccgg	RevEtaKappa
ccatttcacaaacctagtggaattcttgtgcggagagcagttcaacggaaaattgctttgtctttctaagggtgaaacttcattccaactcacattccgcaagactccctttgcgagacaaaacttggacccgcatgcaacaagtcattcagattttcccagtctaatgaatttcgagactttacagggtgcgccataag	ttcattccaactcacattccgcaagactccctttgcgagacaaaacttggacccgcatgcaacaagtcattcagattttcccagtctaatgaatttcgagactttacagggtgcgccataagtatggtaacacattcgcggctctatagcttcccgtgtggagagagttattacctcaatttgtacaagttttgttctcc	RevEtaKappa
ggaaaatgatagaaaatttgaattttccactaaaaattaacggaacatttgaacttcccgcaaaaaattccactaaagaacttgaatttcacgccgaaaattgtcttaaaaatttgaatttctcaataaaaattgactgaaaatttgaatttcccattaaaaatttaccgaaaattcgtttttttttaatttcccccaaa	aacttgaatttcacgccgaaaattgtcttaaaaatttgaatttctcaataaaaattgactgaaaatttgaatttcccattaaaaatttaccgaaaattcgtttttttttaatttcccccaaattttggctgttaatccaaaaattccggaattttttaaaaaaacaattcaaattttcagtcattctttagtgcgggaat	RevEtaKappa
aatacttgtggaatacatcaatttcctatattttttgagaataaggaaatattctgccaatttttttcgcgaagtatacggtatccggtctcgacacgacaaactttgttaaagacaaaaaggtgtgcgcctttaaagagtactgtaatttgaaatgttcgtttttgcagaatttttatcgcttttttgaagttttcgca	cggtatccggtctcgacacgacaaactttgttaaagacaaaaaggtgtgcgcctttaaagagtactgtaatttgaaatgttcgtttttgcagaatttttatcgcttttttgaagttttcgcacgatttgtcaaagttcatgtcgagaccgggtaccgtacttttgacgcaaaattcaaaaaattttgtgtctgggctata	RevEtaKappa
gaaaccaatccaatggagcttaaagaatacatgtttcctcaacagatcaatttgagattaagtcagaatttttgaaaatacttttcctagctgagtgaaacagtaaattttttcgagagcagggctatacaagacaagagccgaattttgaaatgtactgccatttttggggtttttataaaaaacttaaaattcgacaa	acttttcctagctgagtgaaacagtaaattttttcgagagcagggctatacaagacaagagccgaattttgaaatgtactgccatttttggggtttttataaaaaacttaaaattcgacaattttagttttttttgtttctgcatatattttcaggtttttagagacaaaaatatttcagagaaggtcattggagctgat	RevEtaKappa
cagtacttggatgaaatcggccggagctggaaaatttggaagatttaaaatttaattgcatgggcggctctcatcctcctctttgcccttctaaaaaatttgatgcttttcgaagaaattagaatttttggtaaaattttcgaaaatgtcaaagggttccatagcggttggacggtctattttttaaaaaattggttgga	tctttgcccttctaaaaaatttgatgcttttcgaagaaattagaatttttggtaaaattttcgaaaatgtcaaagggttccatagcggttggacggtctattttttaaaaaattggttggacggtctattttttaaaaaatctttagtccaatatcaatatcagttttatatgaaaaaaaagtaaattctctaaaccccc	RevEtaKappa
tactaatgacgaatcttatcgaaatattcttactaaaataacaaagttaaaaaaaattcagtcacagcaaaaattttaaaagattatgtttaaaatagtttaccttctaaatcttgtagaggtttaaactagatttctgtaattgtttaaaaaattcaaaacgtttctcaaacttgacacttttaaaaaaatttgactga	aagattatgtttaaaatagtttaccttctaaatcttgtagaggtttaaactagatttctgtaattgtttaaaaaattcaaaacgtttctcaaacttgacacttttaaaaaaatttgactgacattttcttgcttttaagaggtgaaaatatgtgaaattacgagactacgggacgagactacgggaattactccatttcc	RevEtaKappa
cctcgattcttgaactttgagcagcttctcctcgcctgctgctcctcacctattcaaacttcacacgcctcctagccgtactaataatggatgtaattatccagttttttttctttttttctggtcgagcgcaaattaaaaaaaaaaattttttttaatgcgtgtacattttcccggagctcactcactcaaaaaatgag	actaataatggatgtaattatccagttttttttctttttttctggtcgagcgcaaattaaaaaaaaaaattttttttaatgcgtgtacattttcccggagctcactcactcaaaaaatgagctacttggattacacttttgactgaattgatgaattctaaattcagaattcatcagtgccctccgcaactaagatattc	RevEtaKappa
cacttctgaaatttcagactaatgtgaccattttgagcaaagttatggagccttgaagtttgaagactgaccgcgacgcgaccgcaacgcgtggtcaaaacttcaagtccttgcaactttgctcagaatcgttgcaaggcctcaaaaattgatgtgagtgcctgaaacgggtttgtcagctgtatttatgaaattcacga	gaccgcaacgcgtggtcaaaacttcaagtccttgcaactttgctcagaatcgttgcaaggcctcaaaaattgatgtgagtgcctgaaacgggtttgtcagctgtatttatgaaattcacgagaattgcgtcaagactcgaaaagtgcgtcatggcacgagaattgcgccaagaccccattgttccatcaaaatatagtca	RevEtaKappa
caagtcaattcacgcaaatatccattacatttatatttatcacctactcataattttaatgcttaaaattggatttcgtcgtgggaggatgttcaaaaacgcttattggtacaaccctgagctccttttttgggtaaattagaagctcagcaaagaaaaaaaagaagtttttaagagttggcatatgttgggctacatct	gtgggaggatgttcaaaaacgcttattggtacaaccctgagctccttttttgggtaaattagaagctcagcaaagaaaaaaaagaagtttttaagagttggcatatgttgggctacatcttactaatcatttccgcactcctctatcttcccattatgataagtgttcggaaactttcacatctggcttcggcgcaagag	RevEtaKappa
gcactaatttccaggcactcttttaatgcagcactattagagactgcagtactactggagactgcagcattaattttcgaacggctattttcaattatagatcactagtttttagtcacaaaagctcattttttaagcagaaattcataaaaattgcgaacttttgtaacaaaaagacccaataattcaattacttttgt	cggctattttcaattatagatcactagtttttagtcacaaaagctcattttttaagcagaaattcataaaaattgcgaacttttgtaacaaaaagacccaataattcaattacttttgtaaattatcaaaaaatcatcaaaaatatacaaaaaaaatacccaaaaatatcgaaactgtcaagtgactcttccaatagaaa	RevEtaKappa
ggtaaatcagaaaaaaaacgcgtatttcaaggaatctgtagatcccttcaactataaacaatatttgtttatttttagaatgtttcatttttattttcggtgtatttatttcccgtttcaaattcaattagtaatccaaaaacaatacgaaaacttgctacaacactgtcaacaacttgcatgatttgcaaaaggataat	gtttcatttttattttcggtgtatttatttcccgtttcaaattcaattagtaatccaaaaacaatacgaaaacttgctacaacactgtcaacaacttgcatgatttgcaaaaggataatagatttgtattttattttttctgagctatttttttttggaatttttggaaaataaaccctgaccagaaaattattatagtt	RevEtaKappa
gtctattgtaaaacaatgtacagtataccagtttctcaatacaatagtcgccatgctggctaatacttccatcacacacaactacttatacaagtgaacacaccaccacgcacaaaaacagacagggggaagaggcagttatggacgttttcaattcgacatagttgccaaaaaaaaaactttttttttgtccaaaatac	ctacttatacaagtgaacacaccaccacgcacaaaaacagacagggggaagaggcagttatggacgttttcaattcgacatagttgccaaaaaaaaaactttttttttgtccaaaatactacttccaaatgttacatggcgtgagcatgacaagtgacatcgtagaactgaaacaaagaaaaaccactaattaaaattga	RevEtaKappa
tcgctacgagatattttgcgcgagacaaaatttctcgtcgcgtcgagacccaccactcactaaagtcgatgcgccgtcgaagctggcgatacgatatttactcacaaaaaaaacaattttcctctggaatttctagtttttcaattaaattcaagcatttcattggaaattaatgattattaatcgaatttttttcttga	ctggcgatacgatatttactcacaaaaaaaacaattttcctctggaatttctagtttttcaattaaattcaagcatttcattggaaattaatgattattaatcgaatttttttcttgaaaactaaacttttcactatttgacctactcgtttgacctcccccgctgaatattgatttccagccatttctatcacctaaaa	RevEtaKappa
cgctacgttatagaattagtttctttttgagattcttaatggattcttggtttccgtgaaggtcaaacagtcaaacacaagaaatcggtttccgagaaagtgaactttgttgtcgtgcaattgcaatatcttattgagacttttttacaatgagttaatttcttattttggtacttgtgtattacatactttcattttaa	aatcggtttccgagaaagtgaactttgttgtcgtgcaattgcaatatcttattgagacttttttacaatgagttaatttcttattttggtacttgtgtattacatactttcattttaaaattaatgaaaatgctcattgatttctccgtttaaattgaacgtgatgtggaattttcctcgtttggctcagaaatgcttat	RevEtaKappa
actctttttttgtggagagagcttgagaatgaaattgggtgagaggaggagaaggggaggcaccgagagcgcaactaatttaatattctcttactttgcttttctaggcagacgagaaagagttacggggaaattggaattttgcaatgcaacaacattacacatatgtacacgtggtaccagagtcttatttcggtttg	atattctcttactttgcttttctaggcagacgagaaagagttacggggaaattggaattttgcaatgcaacaacattacacatatgtacacgtggtaccagagtcttatttcggtttgatctacgcagatctacaaaaaatgcgggagttgaaacgcagacttctcaactgacttcgcaaggttaagagcgtgctgacgt	RevEtaKappa
tatcgagcaactcaaggaaccatccctgccaacggaagaagatattgaaggtatgattgcaaagttttccaaaaacattgcatcgaccgggaatcgaacccgggccgccgcgtggcaggcgagcattctaccactgaaccaccgatgcctgatttttcatagttttcgatcaaaagagaacggcggagaagtgggacaac	cgaccgggaatcgaacccgggccgccgcgtggcaggcgagcattctaccactgaaccaccgatgcctgatttttcatagttttcgatcaaaagagaacggcggagaagtgggacaaccatacaaaacaaatgaatagttcggtaactggtttaaatggacgaataaatagtatacatcattaaatctccaaaaattgtcc	RevEtaKappa
tcttttatatcatttttcctcatttttcaagctcgttttatttataagcactaagaagaacgtgttcttgcatagttcttcgatttttaaaaaatttttttatttggttttaaattttttaaatcggaaattgtatgaaacgacgacgattattcgatttgtcgttgattattaaagttttgaaatatttgattttatga	ttttaaaaaatttttttatttggttttaaattttttaaatcggaaattgtatgaaacgacgacgattattcgatttgtcgttgattattaaagttttgaaatatttgattttatgattggaggaatttttttttgagaaattggaaaagctgcctaagcctaggcctaagcccaagcccaagcccaagcccaagccaaag	RevEtaKappa
tgttctggaaaattaaaagttgagtttcgtacaaaaatttttttcgaaaaatttttaaatatgaacttcatacattttttttgaaaagaatcgaatttcccgccaatggttttttttttgataaatctaaatttgaatgtacaggcaaaaactttttggaaataataattttaatttctggccagattttttgaaaccct	aaagaatcgaatttcccgccaatggttttttttttgataaatctaaatttgaatgtacaggcaaaaactttttggaaataataattttaatttctggccagattttttgaaaccctaaaatttgaatttccagttaaaaatttaattcccggaaagtattcaaaaaaacaaaaattagcattactttaaaagtatttgaa	RevEtaKappa
ggggtgaaaactaatagaggaaatacggtatttgaatgcttagcaccaggttttatgtgttctccggtttggctaaagttgagtaaaccggtttccctgtttatgttcgttcgaaatagttattcttgacaagtaacctactttgcttgttttcttgagaaaaatgaaatgattgatggaacaattttttgttttgtaaa	aaaccggtttccctgtttatgttcgttcgaaatagttattcttgacaagtaacctactttgcttgttttcttgagaaaaatgaaatgattgatggaacaattttttgttttgtaaattttccaccacggccgccagtttaaaaaatgaaaatgtaccaataatataaacaaacaagcaaacgcagcatttaggctcgagg	RevEtaKappa
cctgccattttctcacttcttccataaagaaagagaaataacctcccataaaagctggggcggaaatcggaatcctagtaaagatgcactaaaaaacgtcgccttttccgcatcaccatcaacaacgacaacaaaaaaaaaaaaaaaaaaaggctgtaatgcttctctctactgcttttgacgggtaaaaaagtatagga	cactaaaaaacgtcgccttttccgcatcaccatcaacaacgacaacaaaaaaaaaaaaaaaaaaaggctgtaatgcttctctctactgcttttgacgggtaaaaaagtataggaagaggcggaaaacgacatgttggaaaagaggagagagagaggcgaatcttgttaggagacatcgtgcgtcgacaatgtcagtagtg	RevEtaKappa
aatctgtaaactcattcactcagctcgttcaaaaatttcagacaataaagtttcaagtaaaatattggtcgcccctaaacactgtaaaatctttgtaaaaacaacttagagttctgctacaggctcgggcccttcgaaaaaaaaagaaaaaaaaatacatatcagaccaaagtttcacagggtagattatgtcttttgca	aaatctttgtaaaaacaacttagagttctgctacaggctcgggcccttcgaaaaaaaaagaaaaaaaaatacatatcagaccaaagtttcacagggtagattatgtcttttgcaacttactattaaattgttgttataacctagtccaaccgtaagctttgaagtctggtgtgaactgaaacttagaattttgcagattt	RevEtaKappa
ctcagaaaccaataaaaatatttcaaaaaatgaccctttccggcgtttgggagcaattttatatctgtttctaataaccttgccagattgacagaaatttgctcctaaataccgtgttgtcatggagataaggaactatcctaccctttatgtttaaaatcattatcatatgcatttcatattaaaagttcctactggca	ttgacagaaatttgctcctaaataccgtgttgtcatggagataaggaactatcctaccctttatgtttaaaatcattatcatatgcatttcatattaaaagttcctactggcaatttgtatcagttaaaaaatctaaatccgatcgtgatctccttcttctaaagtcaagttttgcagtaaactttcgaaaatatcctcc	RevEtaKappa
acccattcagcttttggctttgaatactttttcaccaaacctttcagtgccaggaaagcctgaaacattgaaattgtgatagctgaattcaatgtgggtggcaaacggttttttccggcaaattagaaaattgccggaattgagaacttccagcaaatcggcaaatcagagaatcgccggaattaaacattttgccgatt	ttcaatgtgggtggcaaacggttttttccggcaaattagaaaattgccggaattgagaacttccagcaaatcggcaaatcagagaatcgccggaattaaacattttgccgatttgccgaatttgccggaaaaacagcaattgccgaaaatttttggcaaatagtggtgttgcacatttttttttggacatttcagaattt	RevEtaKappa
ttcatcattagaggggagacgcgaagagtccatacaggtctgtacaatgcttgtgctgaaaataaagggtgtgggattcagtgttttaatgttttgcttctgctccatttttttttaattttgcaccatttactaatcaccatcaaataaaaactcactcggaaatatcagtccgaacgtgatcaagtttcatattacgt	aatgttttgcttctgctccatttttttttaattttgcaccatttactaatcaccatcaaataaaaactcactcggaaatatcagtccgaacgtgatcaagtttcatattacgttcatcatcgatattgatcaaattcttgtcgtccttaatcatatctgaacactcagctgactctctgactctcagctgaccttcgtgt	RevEtaKappa
ttaatgaaataattgaacaaaatattgaaaatgttcgaagtttgaatttggtgccgaatttttgaattttccgtcaaaattataattttgaaaatttctattttagctgcaatgttttttttttaaatttttctattcttacccctgtttgaagttgatgctgaaatttttagaataaaaaaaaaatttttggcatttcg	ttgaaaatttctattttagctgcaatgttttttttttaaatttttctattcttacccctgtttgaagttgatgctgaaatttttagaataaaaaaaaaatttttggcatttcgaaattttaatattattttattatcgaaaaaatacgatcgcacaaatttctcataatttatttttgatctaccttgttgactaagctc	RevEtaKappa
cttttggcaaccgggattacatagtagttggtgtgagcagaaaattgtactgcaagctcggtgttcccctttattctagtttttgaatgtatttctcaacctgttttgattgatttcatctatattttttaggattctcaaatggccgtgggtttccaccactcgggggacggtcacctcagtcatcatttgactcaaat	tatttctcaacctgttttgattgatttcatctatattttttaggattctcaaatggccgtgggtttccaccactcgggggacggtcacctcagtcatcatttgactcaaatcaggatgttgcacaggtaagactagggacaaaacattgttcgggaaagtcatattggtgggttctatcagttttcgaggcgtgtcaggg	RevEtaKappa
ctgtttttagttattcgaaatctcagtaatttttagagtcgaaccatcactgtatcatttacctgatcacagtaagtattactcatgtcaattgatattttctgttccgcatctgtcgttgttcctataaacaatgttgaaaaataaaaggctgcacaggttcattccagtgaacttactgaatgacgatctcgagctcc	aattgatattttctgttccgcatctgtcgttgttcctataaacaatgttgaaaaataaaaggctgcacaggttcattccagtgaacttactgaatgacgatctcgagctccttggtgacgtccatttgaactccaacgtattcgacgctgttatcgtcattttaagtaaaagtttcagagatggttttagagaatctatt	RevEtaKappa
tgcgctgacacggtgccaaactattacactttgtgaaaattttggtaaattcgtcattttttcagagtatatttaacttgaaaacaataaaataagtgatgaaatcataaaaaagtatgcactttttaaaaaaaaagtcgcggaacggcccattgtttattctagacaaagattgtcaaattctccaaaggaattcggct	aataagtgatgaaatcataaaaaagtatgcactttttaaaaaaaaagtcgcggaacggcccattgtttattctagacaaagattgtcaaattctccaaaggaattcggctcagtctcaaagctttttttactttcggaaagttacaattgcaagtttcactgaaattttcagatctgcctgaagagttggccccgtcccc	RevEtaKappa
ggaggaaagttgtgtggacgtgccgcaaagggcacagatcatggtaaaactccactggaatttatgggaaaaaaccgccctaaaattttcagacaaatgcggcggtgagctaacagcgaccgccgaatggcaggagatggtctacaaggggaagcggacgtgcaattggaaggtgaagtcgccgagcggtgggcgggttc	gacaaatgcggcggtgagctaacagcgaccgccgaatggcaggagatggtctacaaggggaagcggacgtgcaattggaaggtgaagtcgccgagcggtgggcgggttcggttggtgctcaccgagctcaggtaccagtgtgcaccggcgtgtaaggcctacatcgagatcaagcataataccgacttccagcagaccgg	RevEtaKappa
gtcgtttgcggcggaatcagaggacgacgattccggaattcagtgatacgctcgttgaggttcggatccgtgatacctggaaaattgagcgatttttacagatttttaggcattttctgggggttttcaaatttgtgccaaaaaaaaaaagtttatttttattttttgggggttttaagagtttttttttttcaattttt	ttttacagatttttaggcattttctgggggttttcaaatttgtgccaaaaaaaaaaagtttatttttattttttgggggttttaagagtttttttttttcaattttttcttacaaaaaaaaaagttttttctgattttttggggtttttaacgggttttttcaaatgttttcatttaaaaatagttgttttttctgattt	RevEtaKappa
gtgaagaagcgtttttaattgtttttgtagcatataaaaattttctgtgtcgacactggcgcctagcaagaacctttgaatatttcatgaattcaactttgcgaaacttactcagtttttttggtttcgcaaggcgtaacgacccacaaaatcatccgagctcaattttctaaaaaaattctggaaagtcaggtcaaaac	caactttgcgaaacttactcagtttttttggtttcgcaaggcgtaacgacccacaaaatcatccgagctcaattttctaaaaaaattctggaaagtcaggtcaaaacgtctcgaaaaatactaatatgaatttttccgcatactgctactcgccgctcacatccatctttctggcgactatgccattcaagacttaacct	RevEtaKappa
aaacaagacgaatggaaattaacaacaaggtctctacatttgatctacttttctgatttgacatgtctgttttcaaagtttgtgttctgcttggccttattgcaatgacggcagcccaattcggactaaactcgggacttgggcttggagttggaccggcgagagctaatgctagtaagtttttgatgttaaatgtgcta	gccttattgcaatgacggcagcccaattcggactaaactcgggacttgggcttggagttggaccggcgagagctaatgctagtaagtttttgatgttaaatgtgctatgtggaaatattgaaaaatttgttttccgggaattttgaaacatctgtaactttgctagttttacagatgtcaaaatcttgtcaattgaccaa	RevEtaKappa
acaataagcccgagaccttttcaatgacctcttgcgcagtttcacctaattcaaattttttcctaaccgtaaaataaattcaaacatgttttttaaaagaaacaccacttcaatatataaattcttgaaaataagtacttacgttaaaaatgaattttccagacgaccacataaaaggcacaatattgccgcgcaaatcg	aaaagaaacaccacttcaatatataaattcttgaaaataagtacttacgttaaaaatgaattttccagacgaccacataaaaggcacaatattgccgcgcaaatcgacattgcaaatctaaaaataaatattatttttcatcgtattcatagaattccaaccgtgtgaggtgctctccaaacatccatggtaaaatgagt	RevEtaKappa
tccaataaatcgtttcgtgatatacttcacagcgatcgctggaattaattcttggcactattataaaatttattttcaaaaaaaaaaaatactaaaaacatgttttttaatcaataataatctcagcccaaatattggcaatttttaaaaattcacctgatttcccggaaccggccattccaaccaaagccacgtgtaat	aaaacatgttttttaatcaataataatctcagcccaaatattggcaatttttaaaaattcacctgatttcccggaaccggccattccaaccaaagccacgtgtaattctcgaagaggtgcagtattcctcatttctaaggggagacaaaggtgctctgtgagctccccagtcgatcacttttcactttaaacctaaatct	RevEtaKappa
gtttgatgataagagtggcattttgatatgaggaagcttgcagaatctagtggtgaacaggaagctttcgctatggagcaaaatggattccgtcatttttcttaaagaatcggagtcgagatgaaacacccagccggagctgaaaaattattctgctgaaaaatcgaggtgcttgaagtaccagggcgttatacaaaaga	atttttcttaaagaatcggagtcgagatgaaacacccagccggagctgaaaaattattctgctgaaaaatcgaggtgcttgaagtaccagggcgttatacaaaagatccagggatcctagttctgcaaaaaaaatttctgcataatgaaatggagaacagggcggtgcggcaaccaagattttcggcaaccggcatttgc	RevEtaKappa
aaaattataacaaaagtggagtgagacacagaaatttggaaagggaagtggatttaaattgctgtgggaacagtctgaattctccttaaaatttaatttaccggattatgaagaaatttcccaaattccagtaggcaagcacgtttcctcctactgtattcttgcctgcctacaagcttgcctactgcctaggcatctga	atttaccggattatgaagaaatttcccaaattccagtaggcaagcacgtttcctcctactgtattcttgcctgcctacaagcttgcctactgcctaggcatctgaatttttgcaaacaattaaaggatcggaaataattttgcaagtctataggcacgttttgtaggcaggaatcaggtgtaggtctccttacaaggcag	RevEtaKappa
ctgttcgattgatcggattgttggccggtcgccgtcattatttcttgttgacttggatattgcgcttgtggcatgttcggatccattgtggacgaggcgataaaaccggattgatcgttcgtggtcggcattccagtggttgattggaactgaaatgtacgataaagatacaacaccaatgtcactatcacatgcaatac	ggcgataaaaccggattgatcgttcgtggtcggcattccagtggttgattggaactgaaatgtacgataaagatacaacaccaatgtcactatcacatgcaatactcaaggcgctttaaaacattttaattgagtcttaccccggttgatggctgtccattgttgaaattgttagtcgtcgttggtgtcgtcgattggaa	RevEtaKappa
tttggtgaagatttcattgacatactgtttcatgtcacgaatcgtttgagttaaatctcgcaatgacgttataacttcatttttctcgtgttgttggaagcttccgccagcggcgactggagctggtgctgctccaccggagtgaggtactgcagcagcgacaccagacgtttgagcctgctggatttgtgctagcctct	gaagcttccgccagcggcgactggagctggtgctgctccaccggagtgaggtactgcagcagcgacaccagacgtttgagcctgctggatttgtgctagcctctgatccatgttctgcataacctgatgaatagcgttttgagactcataaattaaacgaagttcgcgagcagtagcatcctcataatacttatttggat	RevEtaKappa
cttttggcaaccgggattacatagtagttggtgtgagcagaaaattgtactgcaagctcggtgttcccctttattctagtttttgaatgtatttctcaacctgttttgattgatttcatctatattttttaggattctcaaatggccgtgggtttccaccactcgggggacggtcacctcagtcatcatttgactcaaat	caacctgttttgattgatttcatctatattttttaggattctcaaatggccgtgggtttccaccactcgggggacggtcacctcagtcatcatttgactcaaatcaggatgttgcacaggtaagactagggacaaaacattgttcgggaaagtcatattggtgggttctatcagttttcgaggcgtgtcaggggcgcata	RevEtaKappa
taattgctgacgcgctgacaacgctgattttttttattctgaaatttgaatatagaactagaaagccccccttcgaaaaacaaccgattgaaaacaagttcatcgcagttttccggtattgagatgacattagcatggagataataaaatgggagcatgtgttaattgtcaaaatcatggaaaaaagaaataggcagtgg	agttcatcgcagttttccggtattgagatgacattagcatggagataataaaatgggagcatgtgttaattgtcaaaatcatggaaaaaagaaataggcagtggttgcaaattagtctgaaaacaaaaataacatggatttgtagagtttcaaaattaaactgactgcaatccgggaacatctacaaaaaaccaggtaat	RevEtaKappa
ccaatatttcaagaaattacgacaaccttcagaaagttcaaaaaaatttttgaaatctccacctaaaactttggaattacttttcgtctagaataaagaacacatacctatataaagttttcctaaaaatacaagaacggatataactgcacatccaccgggaagtctccatacttgtttatcctgtgcaatttgctcat	gaacacatacctatataaagttttcctaaaaatacaagaacggatataactgcacatccaccgggaagtctccatacttgtttatcctgtgcaatttgctcatccatatccaaaaatgcagtctctagagctcctttcaccaaatgctcacttcgaattcggttttcgtcttcccgactcatctaaaaaagattacgaga	RevEtaKappa
gactccagacgcacaattggttcccccgagccatcttccttcgggaagctcccccggtgtgggcggagcttgagcatctgataaaagcaaggtccgacgcgaggagaagctcattgtcattcttttttgactatcccccttctaaacaccatggccaatcgcaccaccgccggaggaatcggattcgctgtccgccaaaa	gcgaggagaagctcattgtcattcttttttgactatcccccttctaaacaccatggccaatcgcaccaccgccggaggaatcggattcgctgtccgccaaaaggtttggtgaatttcagtgattttgttaggctattcttcatttttcagcaagactccaagttcatcgacaaggaggccactcttcttctcgaatggat	RevEtaKappa
aagaaaaaagctaaaggagcatgagagggaaagaaggatcatattccttcaggcaactttgagacacgacgctctcaatgaaaagggtcccgcacattcacctatacactttttctcgccttctcaaaaagtgcaagaagagggggaatgattagagattgaaaaaaaaaagaaaatacaagaagaatctcgaagaaata	cacctatacactttttctcgccttctcaaaaagtgcaagaagagggggaatgattagagattgaaaaaaaaaagaaaatacaagaagaatctcgaagaaataagtgaaaaaaggtgtgaacaagtgaaccacatggatgaatccgaagggttcccactgcttttcgttcaccacataaaacaaaatcatattgcctatgg	RevEtaKappa
cggtcaaaagtgggcgggcgcccccggcagagaaagtgtcaccttttctctcaaaattctctaggtttcaagggggaggatggatggcattggaggagaaacttgaaacgggacaactctttttgtggaaatgagggtgaaaagagaaagttggcatctcacttttcagttcaaaaattattcgtttagtctatcctgcg	aaacttgaaacgggacaactctttttgtggaaatgagggtgaaaagagaaagttggcatctcacttttcagttcaaaaattattcgtttagtctatcctgcgagttttagcttgttcggttgactttgaacggagttatgaagcaatttgggtttctaggccaccagtagaaacttcggccatcatttgaattatttaga	RevEtaKappa
ataatttctgatgcaatcagcttaacgttcctgtgcaggtgaaaggaatgatcattgaaatttttaacaaatgaatgaccattccagatgaaaatactgactgttcaatttttatacaccaaaaatcagcttaaatattttggaaaaaacgtttttcacaaacattttaggacgttagagcacactataaaaaccggtat	actgttcaatttttatacaccaaaaatcagcttaaatattttggaaaaaacgtttttcacaaacattttaggacgttagagcacactataaaaaccggtattattgaatttttactgtctgatttaaaaaattgaggaccattttaatttgaaaaaagctgttataaggatttttgagcttactattaatattggtgaaa	RevEtaKappa
ggttggtttccgcagaatccccatcgcggagtctcaataattctttttatttttattttctcattttccccttttccccttttccccctttttctttcaattttccccattttccatcatttttttcgtttttctatgatttatcatcaaaacaaagcacgaaattcaataaaaaaaacaattttcaaccaaaaaattgc	attttccccattttccatcatttttttcgtttttctatgatttatcatcaaaacaaagcacgaaattcaataaaaaaaacaattttcaaccaaaaaattgcgaaaaaacacgtcatttctttcttttgctgccagaaaaaagagatagttctttgtgtacctgtatcaaaaatcacaaggtttcttggcattcggccaac	RevEtaKappa
agaaaagtttattgcgtcgacggagtttgtaactacgcgagaaagtttcgaagagtttcgttcataatatgattttattgtcaaaagcttgaatgaacagtttgatatatgttttcttttaccttcaacctagcgttttttttaattagattcatgattaaacaaataggattaacaaaaaaaattgttttcactctaaa	tttgatatatgttttcttttaccttcaacctagcgttttttttaattagattcatgattaaacaaataggattaacaaaaaaaattgttttcactctaaaaattttagaacattttttaggatagtcattaaattattattattataaaccttatttactccgtgttttgaatagtcttacaacccttattgttctatta	RevEtaKappa
tcaaactgttgatctgggcgctcttctggagcaggttttccagcttcaatctggcgaatacgatcaagtgattgtggctggagagagtcttgaaggataacttcctttccttgaacttcaatcgttgctgttgagacagcttctccagctgcgttcttagcaacacatttccattctccagaatctcttggttcggtttg	tcctttccttgaacttcaatcgttgctgttgagacagcttctccagctgcgttcttagcaacacatttccattctccagaatctcttggttcggtttgagcaatatccatgatcacccatccaaaatcattgatcatcttaacacgagacgacgcagacattggctctccattaaggaaccagttgatcgtaagagttgg	RevEtaKappa
gggcaatcgacagtttttgccactgctggttttcaaaatttttggcaattggaaatagtagcaaaaacttccgatattcaaaattgtcaaaattgtcaaagttggaaaaacttcaatttccacgcacctctatttgtaactatctcaatttacaacacgtatttggaatgtttagaaattcaaaagaaaatcatgaaagt	tggaaaaacttcaatttccacgcacctctatttgtaactatctcaatttacaacacgtatttggaatgtttagaaattcaaaagaaaatcatgaaagtcgcatttcttaatatatttaaagtatcaaaagtttaaaaactatcccgtaactaaatttatcattaaatttatgaaagatgagaactggaaagttaattata	RevEtaKappa
ctataaaaggtcagaagctgtatgttctatgcttcttacaaaaagtcctaacatcgatagtgtagcaactattacaaattatgcaactggtcataatggtactagttcttctctatttacaccaaacggcttatcgcagttggaagttatgcaaagagctaccaacccattagaaaaaattcttgaaattcaaactcatt	tagttcttctctatttacaccaaacggcttatcgcagttggaagttatgcaaagagctaccaacccattagaaaaaattcttgaaattcaaactcattgcactggtactaagctcggtgatccaattgagatcaatgcaatttctaaacttgtaagctcagcttgcaaaataggtagtgttaaatccaatattggtcata	RevEtaKappa
actgtcacacttgaaagctgtgatatcctgaaagtacacgttttgtggaaacaaaattgtggaaacatagtacaaagcaaacatttagaaaaaaccccccactgacctttgtaagaacatatgtgttgaaaactctttgctctatgaaatcagcagcctgtaatattccaaagtagtcgaactaataaatgcaaaatatt	tgacctttgtaagaacatatgtgttgaaaactctttgctctatgaaatcagcagcctgtaatattccaaagtagtcgaactaataaatgcaaaatattagaactcgagactgggatttattttaaaatacagttattgatgtgatgaacacactcagagtaatacataaaactgttttgcttgtacgcccaaatagtccc	RevEtaKappa
gatcgccacacataatttgacacttgctgttcgacggaaatgacgtggcaagcaagtgccagtcgcactcaccccagcattcatgctgaaattgaatccttgtttctgacttttttagtaacgatgaaaattttttatatttgattagagatgtgaatgtaagaaaaatatttgctcaatgttcaatgtgttatttttcc	ttctgacttttttagtaacgatgaaaattttttatatttgattagagatgtgaatgtaagaaaaatatttgctcaatgttcaatgtgttatttttccggaaagcataaaattccactggaaaaacgtaagaaaagttacctgataaaaatgaatatcgaaacttgaaactgtgatgattgctgggacgaaaataaaaatg	RevEtaKappa
cccagatttcggtacccaatctttaacgaaaaagtatattctagaagatcgaggttttttgaaatttttggaaaaaaaatgctgaaattagttttactgctaaacttgaattcccgcgaaaatgagacgatcagcgattttacatagaaaactagaattggacggcgagatttggttaaaattttttaaaaatctcttcg	cttgaattcccgcgaaaatgagacgatcagcgattttacatagaaaactagaattggacggcgagatttggttaaaattttttaaaaatctcttcgtccatcgactttaaaatacctaaatcaagttgaaaacccaagataattaaattgtatactcaaaattagacgattatttcaaaaaagttagttttcagccgctt	RevEtaKappa
tgacgtcacagaatactggaaaacgcttgaggcttctggatggttgaagcacgtgcggagtgttgtcgaatgctcactttttttggctgaatccatcagtcgaggtacatcatgtgtcgttcattgttcggatggatgggatcggacttcgcaagttgtcgcactttgtcaacttcttcttgacccatactaccgtacta	gtacatcatgtgtcgttcattgttcggatggatgggatcggacttcgcaagttgtcgcactttgtcaacttcttcttgacccatactaccgtactattcacggatttcaagttctcatcgagaaggattggctcggttttggacataaattcgatgatcggtgtggacatgtgggggcgttgaatgatgaagccggaaaa	RevEtaKappa
gtgatacaaattatcataattttcatgagaattctgtgatgatgatgattgtattgaaccaataacatttaatcttcccaattgagccattagagcatcttcatctgaatctgaggcaccagcacgaagttctcgcattgccaacgcgtgtgctttctctctgttctcttcttcaagaatctcatcaatagttttatcct	tgaatctgaggcaccagcacgaagttctcgcattgccaacgcgtgtgctttctctctgttctcttcttcaagaatctcatcaatagttttatcctggaaattttataaaatataatttaaatttaaaacaattcaaatgtagttgaaaaatttagtttctaatcgaaaattttgattgattctttctaacgtaaatggag	RevEtaKappa
tgtaatttaaaacgtctcttattgcggaattttctttcatcgacttttcatctcttttctccggatttcaatttatttcagggaaaagaaatagtagatttcactatcaatggccattcaaagttctgttgcattcctgaatatatttcaattgacaaactttaataaatgctttcaaaaattgttcaacatgcttttta	tcaatggccattcaaagttctgttgcattcctgaatatatttcaattgacaaactttaataaatgctttcaaaaattgttcaacatgctttttatttaaatctctcttgctgaaataataacagagctgaaacacttgatctgtatactgcgtactattagaggcaaccgggcgctttacttaaatatattatttaatta	RevEtaKappa
aattttgtagagcattgaaatttgcgcgtcaaatctgatgcatcggtgttgtgtacttgatgcaccatatttgacgcgcaaacttcgtagagagttgaaatttgcgcgtcaagtccggtgtattggtgttgcggactcaatgcaacatgtttaacgcgcaaatctcacagaaaatctgaatatgggcgtcaaatttggtg	cgtcaagtccggtgtattggtgttgcggactcaatgcaacatgtttaacgcgcaaatctcacagaaaatctgaatatgggcgtcaaatttggtgtattgatgtgtccggaatcaaggcatcatatatgacgcgcaattttcaaggcgtttccaggaagtctgtagtttttggcctcaattaggggagtttaaggtcaatt	RevEtaKappa
tttcggaagttcattctcatgaaaaactataaatttagaaatatcctggtgttgcatgatggttatgaccacccactcaactctcaactcactggtcgttattttgacatacccggaattccgaaaaattgtatgcttttgggataaatcggtcaaaaagtaagagaaaataaataaagaccattattttaaacaaaaaa	catacccggaattccgaaaaattgtatgcttttgggataaatcggtcaaaaagtaagagaaaataaataaagaccattattttaaacaaaaaaattgcagatcaacagcggtggctacagtgatcatttgagcaaaaatcaagttttcagtaactatttaaatatttaaatttattttttaaaaattatattgtcaattt	RevEtaKappa
ctgagtttatcatttgtttttggcattctccaaatctccagtggttttcaattttaccattaaattattgaaagtaaaatatgatcgggttaacactcgtataacaaactctaccggtctctaaaatataaaaaaattgttcaagaaatcatgaaatccactatttgccatttaattttgacgtggatattgtgaaacca	actctaccggtctctaaaatataaaaaaattgttcaagaaatcatgaaatccactatttgccatttaattttgacgtggatattgtgaaaccaaaaaatgcatctgtgcaaataaataactgcaaaaactatactttttgtaagttggatttatagtattttgagtattttcaagtgactgtaaaaaatcacactgaatt	RevEtaKappa
aaatgcgtctccgtcaaatcgagctgcgtgttcgattggcttgactgaaaagataatttttgtgtagactaacaattagaacagtacatccggttttactctgtaagaatattctagtagtattataaattgatatgtttttatttttaattaattttggattatgaaataagtgtttatctatactttgatctctgtct	atattctagtagtattataaattgatatgtttttatttttaattaattttggattatgaaataagtgtttatctatactttgatctctgtctgtctggcaatgtacacaaacagtcttcctgcttgctctgtgccccctcctctcgtataggtcgtttttgtgagtgagaggcatttctagccataatggctagcaacgg	RevEtaKappa
cccagaggccagagcaaaaatacccgaaatgaaaaacaccacggtgtagcctcccgttgcttcacgaacaagagctgaaaatatatttttactgcttgtttcacatcaaaatctaatttattaccaaaaattgggggtccgatcaaagatgcaactccttcaatcatagcaatcagggagtatgcaacttggaagaggtt	aaatctaatttattaccaaaaattgggggtccgatcaaagatgcaactccttcaatcatagcaatcagggagtatgcaacttggaagaggttcacatcctcaaaacatattgtaacaagaattgactgcagaacataattactggtgatagtcactccaaagcatactcccacaatcactagctcaacgagtgagttgat	RevEtaKappa
ttatgggatttgtttcttttttctaataaaatccaatcaagttagaaaaaaacgtatctcgtatgctttttgcattttaactgcatagaggcctaaggtatcaattgaagattttttaatggaaagtgtttgaaaaggtgcttcactactatacggtattgaaaacatttctaaatatgacatctcccagaagtacaatt	gattttttaatggaaagtgtttgaaaaggtgcttcactactatacggtattgaaaacatttctaaatatgacatctcccagaagtacaattccaatcactgttggttgacttattttctcatttaatctcaaaatagtatcccttttttttagtacttaacattggttgactgattccaaggacactacatgttcgtgct	RevEtaKappa
aggtttccaacaaaaatgtcatctggcaaagatgcatcaactatgagatactcaataaagaaggttagtttgttgaatcttgctccaaaacatccagaataccttagagacaaaagtttatacatagctattaacggaaactctccatgactcagaattactttgcgattgaaggtttgatctattaaatttcaaaataa	acaaaagtttatacatagctattaacggaaactctccatgactcagaattactttgcgattgaaggtttgatctattaaatttcaaaataactctaagtaacctctctcaatcgaatttagtgattatcatcattatcacatttttcgacgttttcattcattgtctgggcgatttcaatcaacttcctttcactgaaat	RevEtaKappa
tactcattgttagatcttttgctattgaattagttctcgacctgtattttagggagtccacttcgcacgacaggcgttataagctgctggagcttgatgtgaattgatttgaaataataatgattattattattaaaattttgctgattattatgatgaatcagcgaggaccgaggagagttttccgttcggttattata	aaataataatgattattattattaaaattttgctgattattatgatgaatcagcgaggaccgaggagagttttccgttcggttattatacgaaaaatttcgaaacgtttcgaaaaatttcgaaaaatttcgaaaagaattttaggattcgattccaatttgtggaagtccgtgattgcgcgtcaaatgggatgctatgtc	RevEtaKappa
attgcattttctctgaaaacaaagcgattccagacataagtaagacataagagtatgacagataagggtatgacagattaaactagtgaataatgatgttctcaattagaaaaatatataaaaatcgtgtgagattcatgacggttttcttgttgtttttgggattacgtgtttcccaaattatagcatactagcagtta	aaatatataaaaatcgtgtgagattcatgacggttttcttgttgtttttgggattacgtgtttcccaaattatagcatactagcagttattaaaagtctgcaatatgatctccggctaattttaaatttcatagcgaggttttacagaaatcggtgtaggggcagaaaaaaattgccggatttgctggcaatttttgatt	RevEtaKappa
gatgcctgcctgatgcctgttcactgctcgattcctcacctacctcatgcctacctgactgaatatttaccttgtgcctgcctagtaggtgtcatatgcctacccctgtcaagtctattttcttaagtgtctacctcacgcttgccaacacattttagctatgcctgcctacgtgcctatcttatgcctacctcttgcct	gtctattttcttaagtgtctacctcacgcttgccaacacattttagctatgcctgcctacgtgcctatcttatgcctacctcttgcctacctatacgcattgcaaaatttagataaacacaaacctcaaaatcccttcctgatgctggtcacaagtgaggattagcttttgatagtttgttttttttatgtttgaaaaaa	RevEtaKappa
atcatgtgatgctcaaccacatgtacgcgctctccatcaaggacagcgttatggtgctctcatcgacgcaacgctatcgcaagaagttcgtcaccactcttctctacaagcctgtctaactgtttttcttgttttgtggggttttttgttgaaaaaaatcgaaaaaaatgccctgactaatcagcgattagctccgccca	ctaactgtttttcttgttttgtggggttttttgttgaaaaaaatcgaaaaaaatgccctgactaatcagcgattagctccgcccactattgaaccaatcatactgcggtacggtttttcctatttttaattcaaaatttcttgatttcgctcgattatattcttttaaaaaaagtgtttttaactatttttaaatagaaa	RevEtaKappa
gtagtggtacaatggtggtacggtaggagtactgtatgattacggcagtttcagaaaaattggttttcagctccagaagtcgggggccgcgccggaggtgcggtccacggctggtaaataatataaaaacaaaacattatcaaagtcccaataaataatttcagaggaccaccaggtattccttcgccagccaatcctac	aataatataaaaacaaaacattatcaaagtcccaataaataatttcagaggaccaccaggtattccttcgccagccaatcctacaccttcaaatccggtaaccgctgctccaattagacggcaaccaactgtaatacaaacaacatgggctccacagatacagcaaccccagcagcagctagagtctccacagaataatt	RevEtaKappa
gaaatggtgacaatgtgataaaagcgattgtgacagggatgaaacgacgccagatctcaaatttaattatattatagaatttagaaacgcatttttatgcatttgaaattttcgttaattgtagattgtagattaattgtagatacagaccttgtaatttgttcaatttgtgacgaatatcgaacattggttttgtgttt	aattgtagattgtagattaattgtagatacagaccttgtaatttgttcaatttgtgacgaatatcgaacattggttttgtgtttttcgacttgaaaaacgtaataaatcttacctgagaatatctcaatggtgccagcacacatgtcatccgattgacagtcaaaaatatttgaataatagattttgcggctctcatgta	RevEtaKappa
gacatgggagcaggcttaaattttggaatttgtgcgtccaagataaaatctttcagacacccattctctgcgaaactgaaaaacgctgtcgaatcacttgccctctgtcacaacgtcacacctgttctggaaaacggagagctatcctaccaagccgcaagtcctgatgaagttgcactcgtgaaatggacagaaaccgt	acacctgttctggaaaacggagagctatcctaccaagccgcaagtcctgatgaagttgcactcgtgaaatggacagaaaccgtcggtgtaaaacttgctcaccgagatcttcatacaatgactctagacgtccaaccttcaaatggcacgacagttccaatacagtttcaaattctacacgtatttccttttacatctga	RevEtaKappa
aacgtatgtggggtattaatgtagtccattgtatattgatatgtttacttgttgtatgagtaagccaacaatgcctagaacaaatgagcttttcctgaaggtaggcttgtttttgcttcctatttatcgtttttaagtcagttatagtgtacatgcctcataaattttagaacaaaaatcgtaaaatcgtgcttgagtca	tcctatttatcgtttttaagtcagttatagtgtacatgcctcataaattttagaacaaaaatcgtaaaatcgtgcttgagtcaatctcataagttattggaatttagtacctcaagaacagagactaaaaccttccgaacaaaaaataaagaccaataagtaataaatttatgactacagtcaatagcaagtcatggcaa	RevEtaKappa
cgagcacatctccatggttccgaaagtaatcacctgcttgaagcgaagaggaggtgcatatacatatgagttgaagggaaacaagaggagataacatttcgtaaatagaggttatggagaaaattgattgtctctgtctctcgactttatattgtgtctaactattattattgaacgaagaagtgatggttgtcaataga	gaaaattgattgtctctgtctctcgactttatattgtgtctaactattattattgaacgaagaagtgatggttgtcaatagaaacggactgctacgagaagaaatccctcgggtaaagtctcaaggtgtcgttgtcgatggaagcgagctcacaaattagtatagtaggagagttataaaaaatggaaatatgaagggaa	RevEtaKappa
ggattgcggccgacaatttccgagtatgcccactcactatactttatcatagaatgttacaatgagtggctaaactcgtaaattgtcggccgccgtgaaaacctggacacttgtgcggacgccggacgttcgatatgccagccctaatcctaccaattaggggaaatattcgaaaagaggagacaatgtgggcggagcaa	acgccggacgttcgatatgccagccctaatcctaccaattaggggaaatattcgaaaagaggagacaatgtgggcggagcaaaaaccgtgccagagttgcaaaacttttgatatttttcaaaacgaaaatgtagatcgaattttattgttcagttttctgctatccaaaataattaaaacgtgaaaccacaatttttcga	RevEtaKappa
taacgtattataccagtttttgatttaaaaaaacaatgtttgaacagttttggtttcgagcatgccgttgaaatcttgtcaaaattgtgtgtggacccccattcatcaaatcgttggttgttctcgattattgacagccgcgggtattttcaccctctccccaaccagctaattatcttcgctacatccatccctataat	tgttctcgattattgacagccgcgggtattttcaccctctccccaaccagctaattatcttcgctacatccatccctataattgctcattcatcatcaaaacatcggctattcgtgtatctttacagtaatccgagtaacagcatcatcagccgacggatgaccttgattcaatgtttgtggattgaagtttataggttt	RevEtaKappa
gcgtgggggagtttgaatttttaaatcgacaaaaaaatccctatttttcaagcagattttcagattgtaatacaaaaaattatgacattaagaactttggtgctagttttctgttctttgagaaatgaaaaaatttcttcaaaaaaattttattatcgtcatttagatcaattttgggaagccttatttttcaagtttaa	gaaatgaaaaaatttcttcaaaaaaattttattatcgtcatttagatcaattttgggaagccttatttttcaagtttaaaaattttttaattttttatattgtttcaaaattttcagtgaagttttaaaagtttataaagctaattttttagaaattttcgctgaaattcagacacaacgggaaattcgaaattctattt	RevEtaKappa
cgaacagtgttaggtaaaacgcgttgaatgtgaactgaaatttttgaatttgaggtggatttttttggagtaatagcgaaattttgatcatcgctctattagattcaaagtggctccacaccagcgaattttatttggaaatgtttcgaaaaagttttatggcggttcaaacattaaaaacatctgattttctcaaaaaa	cagcgaattttatttggaaatgtttcgaaaaagttttatggcggttcaaacattaaaaacatctgattttctcaaaaaaattattagttttttaaacaaattttatttgtttttttttgccgcaagttagttcaactatcacatatcataatatttgctttttactcaaattttttgaaaatagtgttttttcagtcgat	RevEtaKappa
gttaattttttgttgaaaaataaataataatttttttttatcttgccgtcaacttaattttcagaaaaatatttaaaaaaatcgggcggaggtgcaacgaaaagggtcttgccggttcgatggaatggattggagtgaaataaactgaaacgctgtggtcgctgatgaaaatttcgagaaatcacgaaaaatggatcgta	ggaatggattggagtgaaataaactgaaacgctgtggtcgctgatgaaaatttcgagaaatcacgaaaaatggatcgtaaattttttttcttgtctgaaaaaagggtaaagttgcaaaaaaaagtctaatttaaattcaaagagtgcagtccagtatagcgagctaaactgcgctcgcttttattttgaataaacaataa	RevEtaKappa
attattttctttcaaggtttcaaaagtttcacactagttgtgttcggcaatttcggcaaatcgactttttaaatatttgcctagtacggaaaattcggaaaatttgccgtgactcgctaaatcgcaatattttttggagcttaaaaattgccaaaattaatggattaaactaagtttactggtttttgttcgatttttgg	gcaatattttttggagcttaaaaattgccaaaattaatggattaaactaagtttactggtttttgttcgatttttggctaatacgcgtgtgaatttcttgaattgaaaaataaaagaaacacgatgttatgttttgtttcattaagtctctgatcaaaaccattagagatttgaacaaaatttttataaaaattttttca	RevEtaKappa
cagaagatcaaagggtttgctaatttttatgcgatcagggtttaattttaaatgtttttcaggctgcaaaatgttgctgtggggacgggttctttttcgattttcccaggaaaaagtgtgaggttagttttgaaaaacgttttagttaactaccgtacctactgataaagtctttagcgttttgacatccagtaaattta	gttttgaaaaacgttttagttaactaccgtacctactgataaagtctttagcgttttgacatccagtaaatttatttttgaataatttgatgtcacttgtttttctttctatttctggctcatgactataaaatttttcttacctcatatattttaatataattttttgacaatttctggagctcaaataaagaactaat	RevEtaKappa
tagttcgatagaaccattttctttttgaccaggaaggaaaaaaaggaaatgagccaaacacgaacgccattctggtattttgacaattttaacgaaaattgtaaacgaaatttaatcaaagtctaaagttgttttttttttaaacgctaacaagtgtgccgtgaataacagaacttctaatgatctttgcgttttggtaa	gttgttttttttttaaacgctaacaagtgtgccgtgaataacagaacttctaatgatctttgcgttttggtaattatttttaaacttgggcttttgggaagaagtctgggcataggccctacgttcttatacatactccgcaaattatctgggaacactcttcaagttctcaaggcaaccgggcaacactactttcatat	RevEtaKappa
ttcgaaaccgtgcggcagttgcagaaatgggcgtattgcaagccacggttctgtgggcggggccaatcccccgagttggtaatccccccaattggacatcccccgagttctttgggtctcaaaaaaagtaaactataaattttccgtggatctgcaaaattacgtgaagtgtttgtttgcttacgttgcataccgtaatc	taaactataaattttccgtggatctgcaaaattacgtgaagtgtttgtttgcttacgttgcataccgtaatctggaaagccgccaatatcctaaatttctcatgtcaaaaatcttcaagcttgccggcccaattaacattttcaattaacaccgaaaacaccggaaacatatttttaaaaatgtaaaatgaacacgtgta	RevEtaKappa
ttaactaacctgttgctggaaaacttcgtcatagttgcaattgttgtcataaaaaattggtactggtccagggtagtgtggcttgtcccctgcctgaagaccgttcaaaatgtgaggagcttgcgcagagctttcaaggaatgcagccagttcatcaaaatggattagttgttggttttgtgcagatccttgcacgtgac	agctttcaaggaatgcagccagttcatcaaaatggattagttgttggttttgtgcagatccttgcacgtgacttgatagttgaggaagcatggatgaaacaaaaagttctgaaaattaagaaattgaacttaaccgtgagggagctttatacaagaaatcagaagttttaacgagggaaggcaatctgaatttcaggata	RevEtaKappa
aggtcgattttccaactttttgttcttttgcatataatttttagaaattgcagaatccgatgccaatattaatttttcttaaaaacgttcgtaagtgccctaaaccgctcaaatgaagtagatcgcatagcaattgtgcgcactgtatcaaaggtttcacgtggtgtcaggctgtctcattacagtttgatctacaagaa	agcaattgtgcgcactgtatcaaaggtttcacgtggtgtcaggctgtctcattacagtttgatctacaagaaatgcgggaatatttttacagaaaagttgtgacgtcagcacgctcttaaccatgcaaaatcagatgatatgtctgcgtctcaactcccgcatttttcgaagatcaaatcgaaatgggactttctgacta	RevEtaKappa
ctcctaccctttcgtgtaaatctaagcgggcgttttgaatagtagaagtattggggactaaggggatcatggtattattttgaatttttggtgaagggttctcagtagcttcagttacgtttgggcaagtctcacgaggaaaaagctccggagagtaatgttcgtcgggtgagtcaaaaagggcagcggatggaatagtc	tctcacgaggaaaaagctccggagagtaatgttcgtcgggtgagtcaaaaagggcagcggatggaatagtcaaagggggagccgacggatgttgaacggtcattcctgcatccatcaaacactcttgaccatcttcccgattttccgtatcaggaagactgtccatatccgaggattggacttcgagtggaatgagttgg	RevEtaKappa
atatcttcaccatcttgcctaaactttgtcaatttttagttttattcttcctgtggaaccattttatatttaaaatctgaagttattaatcaattaataaatcattcattgcaagcactgaccaacgtcacagctctacaaaaagtgaagatattatgccatgatctgtagagcgcaagaaatatacaggtaattaaaat	acagctctacaaaaagtgaagatattatgccatgatctgtagagcgcaagaaatatacaggtaattaaaatgttcgaatgacaaattaaaaaggactgagaacatatattagtgattaaaatttccacgccggtcgcttttcggaggacgaatctttcttagttcggctgaacaattgttgcgatggtgagcttcgctcc	RevEtaKappa
ggaaatcttcgatttttatttattctgaagattttgaacacttctctgaataaaagctatcttctggtgttctctttttgatcaaatttattttcttctctttagtaagactttcacactctgggaaatttatcatacttttagaaagacaataccttccactagcatctctttttagatcattcacaactcctttagaa	tcatacttttagaaagacaataccttccactagcatctctttttagatcattcacaactcctttagaattatgaggaatattattctgtactagatactttttgattgttttaggtgatattcctgttttcttagaataagatgaaatactattcattttaaaatcatatattttcagctcttctatcaattgttgtact	RevEtaKappa
tttcagtaattctgtgccttctttcgcccatcgtaaatcaaaaaagtctctagtagagacatatcataaaataaatggtctctgtcttctcttcccacactttccgcctgttccacccatgacaaacgacgacctgaaacctcaagagatgattgtgttgaaacggatacatgacagaaaaaacgaagattattagatgt	ctgaaacctcaagagatgattgtgttgaaacggatacatgacagaaaaaacgaagattattagatgtcttcaatattctccatttcctgcgtcttctctatttcttccaaactacgtgaactgcgcaggttgcagtgattacataaaatgactgatttgtgtatatccatccatctcctctttctttttttttcttccgt	RevEtaKappa
cccgacctgcggaacccaaacatatatttttcataaatttcagactcgaactagccgagttatgatagtttttaccaccgccggcgagagaaagagggcgcagacaatgagggtgtctcgtttctctgcgccctctcgaaatttcaaaattatcagaaatatgttatgattatacttaaattgaccgggaaaatgtgctg	tcgaaatttcaaaattatcagaaatatgttatgattatacttaaattgaccgggaaaatgtgctgaattcaaaaaattgagttttgaaaaccctagaaaccaaaaaataaatgtttttccacttttctcaaattttctaaaaaaatctctagttttctcagcttaatctttacattaatcatagcaatagagataatcca	RevEtaKappa
gaaaaagatattggacgatgggggggggggggggggggaagaagctccgccaatatcatatatacttcacaacacttgagagatggggctcttttgccgcggagcacacacacacacagagacaataagaaaatattgcgaaaaagtatccgtttttttttgtgaagaaaaacaaacaaaatttgctaattggtagggaa	ttgcgaaaaagtatccgtttttttttgtgaagaaaaacaaacaaaatttgctaattggtagggaaagtggggagaaagtttgacgaaagtttagcggaagtttgataaatttttgatttttaaaatcagtaaaagctgccaaaattttgccgaaaattagagaagtttaagaaaaacttggcgaaaactagaaaaagtta	RevEtaKappa
gacactatttaaaaatgaaaaatattcattgtagaggccaaaaagaacggtcagaacggacggattttagccctcgagtatgaaattgcttaaaagaaaaaaaatccttaataaaatttctcactctgccgcagtgatggattcggcggaatctgctccgatggtaagacatcactgggttttgacgatgtagaagccaa	tggattcggcggaatctgctccgatggtaagacatcactgggttttgacgatgtagaagccaaaatcaacaaggaatactacattcagaagatttttgtgccggaagtgttgccttggtccaaatcccacttcaccaaccgtgattggacgtcacagcatgacgatgcgcctacccagcaaatacgactcagcagtgatt	RevEtaKappa
atttacggcgcgttgcgtatcgcgtcgcggcttgtaaaacaaaatctatttgtccgtgtggagtacacgactttcccacgcgttgtccggcgggcgattgtcaatgaagcgcgagaaattcaatgaggaaggccctaactttttgggcaaaaaattttaaatttttgttcgaaaatcaacaaattaaattaaacataaaa	tttttgggcaaaaaattttaaatttttgttcgaaaatcaacaaattaaattaaacataaaactttaaaaaatattgaaaaaaaatacagttcccctaatttatagcttgccactttaaaacgatatagaaacacggtggttttttacgcctgcctatttcatgcctgcctacgtgtctacattctgaggcaggcaggcaa	RevEtaKappa
aatgcttcgctcgtttcatgacgtaaacgctcctatttcaaggtttgaatttcatttttgtcctttacaagcgttttcttactttaaagcaaagagtttgtgggtttttcgttaaatagactaaaactgacgaatttcataataaaaatgctcaaaattcagaagaaagagtcaaaatttgctaaaaaataatgaaattc	taataaaaatgctcaaaattcagaagaaagagtcaaaatttgctaaaaaataatgaaattcggtcttcacgggccagttttagtattttaaagccaaaaaaatctcacaatctctaattcccctttaaaatactttaaaaataccgaattccatgaagattttgttaatttaaaaatgttttgttcgatattgaacaatt	RevEtaKappa
cactttttgctcggtgagcaaaacgggcattttgagttttgcaaaacccgcaagatgtcgggtgctgcagaactttttgaattcgatttccaatgtttgctcatgattttcaaagattgcgagatggggggggggggggaatttcccatttctcatttttcacattttctatattaaaaaccactatcggcatcattttt	atttcccatttctcatttttcacattttctatattaaaaaccactatcggcatcatttttgaagccaaagcggtgagaaaaagcttttaataaaatgaaatcatgattttaaaagatgaagaaggtgtcaaagatcagggaaatcctttttttaaaggattaaatgatggatttggaaaattccaaaatgatctcgaaat	RevEtaKappa
cccatcaaccttttcttttccacttttttccactttttcctcattttttcaaatccaaatcaatttccaatttgaacgccactttcctcccaatgtttcatgccatgtttccacaatatgaatgccgtcgtatttaatttccatttttgctgcccttctctgaggagatgtcaggagagacgacttcccactgtgcacct	catttttgctgcccttctctgaggagatgtcaggagagacgacttcccactgtgcaccttcgataatcagactttgatttacattttataagtgaaaaggtagatcaagcttgcttccaccttcactgcaaccgcccattccgttttttttgaaaaactttccacatttgcatttcctctgtgaaactccgcccaatctt	RevEtaKappa
ttctgttgttattccacagtgtcagccgcctaatggttcgttttttcttaaatttgcgcgtcaaacatgatgttcacattacaattcgccgcaaaaatttgagtttcaagtaattttattggaaagaagcgaaatatttacgggatttcaaatttgcgatttttggttacaatacacaatgtttgacatgcaattttcaa	ggatttcaaatttgcgatttttggttacaatacacaatgtttgacatgcaattttcaacgaagtatgcaattacgctataccgcactttttctaggtctcgaagcgattttttcaacaaataaagtttgcagactgttctgtgcacgtgttcagtgtccgactctcccaaaaaccagaagctgaagatccagaaaatact	RevEtaKappa
agaactctcagtgcccaatagcagaaacggtgaaaaaacgccagtgatacaatggcaagaaagaagagacgcagacaatggtcgtcaaatggggcacattgaccgcaaatactctcacagtgtactagtaacaccaaacgggagaggtagatggataacgagtagtcatgaggctgttgggtgaggctcacatcagttat	aggtagatggataacgagtagtcatgaggctgttgggtgaggctcacatcagttattgatttggagttgtcatcacagaaaaccaattgtttatttgaaggagtatgtgagattttgttcaattttagaacacacaggtgtataaacttaacaaaaattgcaaaaaccgagagttaaaggaaaaggaggaagagtaacta	RevEtaKappa
aagcagacaataaaaggtttacagatacagctgagaatccatatctctaaaaaaaatacgaataaattatgcattcatgtgagagtttaataactaattgcagtgaactaacttttaaaaatgccatgagaaatccgaatcccacaaaaatcattagatggacatcctggaacactgcaataataaatcatttttgtttt	aaaatcattagatggacatcctggaacactgcaataataaatcatttttgttttaaattttaatcaggattcttacatggataatcagttcctgaataaactctccgagaatcatcaagtggatcaatgtattttacatatttagcaaaaagaacaataaaaacagtttgcattaatccagcaataattgcaaattgtcg	RevEtaKappa
agctctctcggtagagaatgtcccaattccttcttttcgaatatagatgttagaaaaattgtaaattttgagcaagtgatgatcgagttgataaagttttcaactagcttcggatccttctgcttgttaagccataataatacgtagagatctctgaaatgattaattgtgtaatgggctcgtttaagtggtgtcaggct	agatctctgaaatgattaattgtgtaatgggctcgtttaagtggtgtcaggctgtcccataacggtttgatctacaaaaaatggtggcattttttcccaaaccatgtaaagtgggttaggaattttgcaactaaattctcgcgattttcgtggacactctaacaccacgcgtttgtttcgaacgttggctgataaaaatt	RevEtaKappa
acaatatatgtatattgaaatgctaaaaaaatttatagttcgcagaaaatttccaaattattttatggttagaagaagttggcaaaaactaaaaatctttgaaaactattgtaagcttggaaactatagaaagatttcaagtattctgtttcacagcatttgtagttaaaatacgtgttctgaagaatattggttattcg	tcacagcatttgtagttaaaatacgtgttctgaagaatattggttattcgtttgggtacataaattaccaatataaaaaagtattctcgaaaagttcaaagaaattttagtgtgtaaatttttacgatgtaaatacaattcattaaaatctagtcagaatataaaattcgtagagaatacaaattttggtcgacttccgg	RevEtaKappa
aaattttccaaaatcaccaatttgaactattaaatttatgaaaatctatttcagttgagactcgattcaatacgtacaagaaaaaatcagaatcatctgctactgacacttccaatacacctccagttgacactgtgaatgtagctctcccgactccagtagtagaatcgtcttctacgaccgcagcaccgtcaatccct	gtagtagaatcgtcttctacgaccgcagcaccgtcaatccctgtttcgacacgtcctgaagtcgtcgttccacctgagaatccagctccactcagagaagtcggaaatttctactctaaatcgaatcacgacgaggatagacgcaatgttcaacttcctttcacaccagcggatacgcacaaaccgattaaagttgcgcc	RevEtaKappa
aggaaaagttgggtgcacatataaacgatgaagaaactcaatatcattgcatcaaattgatcatgatatccgccagaagttatcgaaattacccaattcaagaaaacggcatttttgattgaaatagctgtaataactatgcaaaccaagtgtgtaccaaaccaccaagaataagtaagttttggagtttcggcaatctt	aaccaccaagaataagtaagttttggagtttcggcaatcttatatttgatgaacatataagtagataaaacacagagcatcattagatcgagctgtatgtatgtgtaaagcgcatagccgagaaaaccgaaagaaaatcacaatcgtcttcagaaacccaattgttcctgaaatgtattattttatttcgataaagcgta	RevEtaKappa
gtgattctagtagatcaaatactgatttttgatccttatcttttttctctcaatttatcggctcattttatatttattcaaatcaatcttgagaaaaattcacttgaaactaatttataaggaaaactgtatctatgggcagttttcaattggtaatttatctgaagataaggatctaaaagaaaaaataatgaattacg	tctgaagataaggatctaaaagaaaaaataatgaattacgtaccaagaaaactttgaattaaaaacaactatggccttcaaaattgcaaaaaattatgtacataaaattcaattatgatgtttctaaatttgagcaaaattgagtttcccgaaaattaatactcgtgaggttaagaaacattcgttctactcatagtagg	RevEtaKappa
cattcttggttctgcacgagaaacacgtcagcaaacatgccttgacgcttttttttcatatgttgcaccaaagaaacgccagcaatttggaattaatagcgcgctttcggttttgcacgagaactgcgccaaggaattgtgatttgctgacgcttttttcgatcttacaccaaaaatacgcctgcggtttggggttgctg	atcttacaccaaaaatacgcctgcggtttggggttgctggcgcttttttggatactgcacgtttcgtcaacgagaaatgtgccagcaatattaagctgttggcacacgttcagtgaataatccaaaaatgcgccagcaacgtgttgctaacgcacttttagtgctacacgaatagtgcgtcaaggcaccagaaatgcgcc	RevEtaKappa
tcagtacgcaaaaggtctgtttgagttttagctttcttcaaagtttttgccaaaactgttttttctgaaaaatcgagtttttttctaaaagtaatatttgccaattattaccatacagtaagttgaagatattttgacgacggaaaaaaacgttttctggaattgtaaaaaatttacaattacattgaatcattaataaa	taaaaaatttacaattacattgaatcattaataaaacaaaatccgctcagctttaaaaattagattctgaagaaaagcacaaatatttcaggagatcataaacgtttaataacataacttttgttaaaacagacatgcagcaaaaattatatactgtgacccaaaaaacattgacatccccgtaacattttgatagtatg	RevEtaKappa
tgtgacttgaaaacttgcaagccaaagccaagagcaactgtgtgccgagcagcaatcggaatttgtgatctggacgagtattgtaacggagaaacaaacgattgtccggcagacttttttgttcaaaatgctgcattgtgtccaggaaaggaaaatgtaagttgttcattgttttgtataaaaatagagaaaaatatcaa	cattgttttgtataaaaatagagaaaaatatcaaaaaaattactgtcaactgtttttgtttgcaaataatgtgtgctaatattgtttttacaacatttttaaaaagtaaccttatcgcaccagtaaaagaatgtcttaaaggtggactacgctcagtggagaaattgctttaaaacacgcctatggggccacaatgaccg	RevEtaKappa
gtttttagtgaagcgattaggtacaaccaacaagtaactctattgaaatctaaggaagccgagatacaatatatcgttgattatttcaagaatctcaccaacttccaacagaatatcaagaattctatagataaagctctagcagaaaaaccaaaaaagaccagagaaattgaatctttattgaaaatcaagaatattca	attgaatctttattgaaaatcaagaatattcatagagtatcacaagaattcggtggaggagtacaagcacttaaagctatccaacagatacttcagaaagaggaatcagtgttggctctggctaatgcaaatcaagatattgtacgatttatcaatgatgatccatttaataataaaactatgaaacgattgaaggatat	RevEtaKappa
ttttaaaaatttagccttacaggcaacatttgcctaatttatgcctactcgtatttttatataatgtgtttcaagcacgaagcaggtaggtaggcctacctacctgcttcgtgcttgtaacacatttgagaaaaggtaggtaggtaggtaggtaggcaagtaggtaggcagacaggcaggatgtaggcatgagataggca	agacaggcaggatgtaggcatgagataggcaatggatctataaaacttgcacattccttatgctccaaaagagtactaaatgttgcaagaacctccggctgctcctttctcgaccggtgcgacaatttccttccggtttctcacctatactacaccaattacgatagtatgagtatgatgagtgagagtgttttgtcctc	RevEtaKappa
tttacacgtggaatttgtctcaaacataataattctttgcagaatttagctccttcaattcctgttgaattttttcaaaataaaactatattcacacgaacatttatagttttgatgatttgaaaaataataaaatagatatggcaattggtgaaaatgggtcttcagaaattatacattacgaaatttaaataatatcg	ttatacattacgaaatttaaataatatcgagattcctcgattcctcgatttccatcgttgtattcaggattgctgcaatttttttttaagtggagaatttaagaaaaatgagaggttcagttactacaaggtaaggaaatcctgacagtgctattaccaagaccggaaatttaacactttttgaaccaaaagtacagtac	RevEtaKappa
atttttgttcgtttcgacttccgttgaagatactttttttaattttcaaattttcgtgaggcaagccagcaattttagaaaaaaaaacccttacttgcctgtttactttgcagtcaaattatttatttcgttgaaaaattctgcatcatccacatgtttttctacttatttttccagctcgttttccagttttccttcaa	ttccagctcgttttccagttttccttcaagccaaactcgcacatcctgcgactcatccaaattttccgttttcctttttctactttattcgaatcagctagtttatgtcactcatttatcaggaaagagtaacgatgagctttgctctttttctgaccttctgcctaatagcttatccttgaatattgattttttctttg	RevEtaKappa
tagtgaataatatcaataaagtcaactcgcaatgtacttcggacacaattcgtgagaaattctataataaacgtcacactgtcgcattacggtttgatctacaaaaaaatgcaggaattttttgcacaaaaatatgtgacgtcagcacgttattagccatacgaaatcagctcccgcgttttttgtagatctatgtagat	tttttgtagatctatgtagatcataccgagatggagcactctgacaccacttgaaactttactcactgattctatttcagcaagctcattggcaacgttgactcagtatcaagtaggatctgaaggagatcgtaagaacaaatatttgattgaacagaaaatcaagttatcttgataagtttcagcgtattacagtcatt	RevEtaKappa
tatctgaaaataaactttattttacttgaaacagctaaaaaatttatttaaaaaataaaaattttcgaaaaaaaatttttttttttaataaattttcaaactcacacaatttttaataaattgttcagttgtttcaagtcaagtaaaaattattttcaggtacagaaaacatttttctatattgtgccttaaaattttaa	tgtgccttaaaattttaacaaaaaatatcgggagaacgtgtcaagctgccaaattttgtagaattaccgcgcaaggagacccaacgggactaggaaacttctaggcggtgtaactttgcggggaattgaagtatagaaaaacaaagtatatatttgaaatctgcgtaaaatgtgtaatttcatatcattttgaattttaa	RevEtaKappa
ggaaatttggtgaagccattgatcttgacgaagatgggatttgatgggtatctggaaatattaaataattcttttttttttaaatataacacttaagaaggttgtaataatttcgcgagagtttaaaatcttaacgaaggagtatacatagaataaagaaattgtttcaaaatgtagtatctgtgacaaattcttagtca	tgacaaattcttagtcacagaatttttagtcataaaaatcaacctttaacatttaactagaaaagtcctaggccacgacgttaatttgaatttttatcgttttttgaatcgtatttttaataaatagtttatataattttttcgtctcagttttcttaaacttttgttttaaaaaattgaggaaagttacaaatatggcc	RevEtaKappa
caattgaaaaattcaacaaaatggcatcattatttaaaattttttgacgatggaaattaataattagggcgagacacatttcgctataaattaaaaatttgcagtttatttctattttgagaaagctcaaatttactgtgaaaatttccaaaagttaatcgaaagccttagaaaaatagttaattcgatctgcaaatata	ttcgatctgcaaatatatgaatggcaaaaacggagtgcgactattcaaagtagatctttttaactttcaactttaaaaaacctttttaaagatttactgtgacagttttaaacagttttcccatctttggattttttaaccaactttaaagtaaaaataattgatagattatcagggcttccatgggagcttaatgtgtt	RevEtaKappa
taatcgtcccgtacctattataaacaaacaatttcggaatccaaaccatagtttgtggaacaataacttctcgttgacctcgatatttacttggatcccagcttaatcttccatcataccatctttgtgtatgagatatcacgtaagcagcgagttgttgattttctttctaaaaatttaattatcctaattcagtcatt	tcctaattcagtcattcaaatactggaaaaaagtgtttaatatttaaaataaactggattctacaataaatgttttatttttctcttattaaaaagctatgttaaaatttgctgaaagaactcactaattcaattaaaatccccaacacaatagtcatattcaccaaaactggtccttgaacaaatggaagaactcgtct	RevEtaKappa
gaactaaaatcatatattatttggttcgttatctatcgggtctaatatattctatgtctttactattcttcataccagaagatcaaaattccgcactactccaagttctaaccaaaataccatgcccgtctcaagaatttttcacggcttccgatgtttttgtattgtgtatcgatgagaactacgtcacgttcctggca	cgtcacgttcctggcactattcacagggattggtgtcttgacagagatagctcaaattgtatttttcttagcgtgttgtgtatattatttatttgtctcggtacgatcattcgcttctaaaaagacacgacaaatgcaagttaaatattttgcaagtataattttacaaatatcaattccaatgggattcatgatgccta	RevEtaKappa
ctccaaaaaatgggacagaaatcggcgaaaagggacaaaaggagcgtggtgacttgcaatttgtgtagaaaatggagggcaagttggggcgggctcttcttcttccaaaatacatattcattcatctttttttgcccatttttggtgcgacaaattcctagaagctagcgtgaaccaaaaggaatgtcccgacggaatca	tcccgacggaatcagtgtcagagatgggaaagacgacacaaatctcgggaaggagggaagaatgattgccctgaaagagaaggcggagggtagatcttcaattgagatttcatatttctataggaaaatagtatagaagatgaagaaacggagtatcaatgaactagtctgtgggaaaaagggggcggaatctgatttat	RevEtaKappa
ataagtttttgttgtaaaaagtaaaaattcttaatttaaaataagaaaaaataatactttccaaactatgcgtatgaaactaaaattcgtaaataaaaaagttggcaaagtttaactgacagtaaacataccaattcggcaaaaataatacctaatcaatgcaatgtcttaaatttagttgatattggatttttcgagaa	atttttcgagaaatttttgaattatttagaaacaactgtttcattgttattatagacgtttcaataatttttaagcaatattgccattcagcaagtttttgtgtggaaaaaaaataacttcaatgttcaatcagtagaaaatgttgaatattcctttgcatttaatcactgcgtaaagtttaagaaaatcattcaaataa	RevEtaKappa
cttcttcaccgtcaccacttccttataaatcttctcgttattacgtttgtctctaaagttgttgaaaataattactagataccagcacctgtgcctacctgaaaaatctccaacacgcgacaacaatcatcatcatccaaatttgaaggactatgacaatcgcgaatgatccagccatcaaccaggcagcataatctgaa	aatctgaaaatgatgaattaaatctgaaaaataaacataaaaactaactgaaatacgctgtctcatcacgtggatttactggaataccgtatgatccaaggactgttgtgccaacttttttgtctccaaaaagaccgatatacatgaatgaaacgaaaaagataaggccgatggcaagcccagcaccctgaaattattat	RevEtaKappa
atttttgaaaaaatctagattttaagatattcctctggtggtacccctgctccaagactccaaaaaaatcaatttttcgccaaaaaatgtaaaatttccggcctcccttcgccgactgcgtctcccccgcttctcagtctttcggctttttctatattctgtcatgtgcttcttctgctgctgctgctcgtgcccaccca	ccacccagaagccgttgctgtgtgctctcaaactttcactacacactcgagattttcaatgtcttgatgcattaatttccatttcaaaacctgttttttgacagtattatttacaaaaaaaagtgacacgcgaccttgagaatctctctaccgattttgaccaaaaacattcaattaacaatgtttttcttagtttttgt	RevEtaKappa
ttcgtttttctattcaaccaaaatttgcatattctatactcaataccatattgatggtccggttgtcccacgagactttatcataaaaaggtcattatatgcttcttctgcttcttttctcgcgcattagtacgtttttgccgctttctttccgcgcggaagagatatatgtgtccctctttgctgtccccgccttcttt	cttttttattctttcttgttgttgtgcgggggaggggggtatcccttgacttgtatcatcgcttttgcactttgttagcaacgatcccgacagagggaaggtcaatcacttttttatgcagatgttgttgttttttcgaggagacggaagaaaatttggtgtagattatttagtggtcaattgggttttccttctgtctt	RevEtaKappa
agaaaggttgtcatactgtgccgcaggaaaggtgacattgattggttctctatttttgaaatgaatccaatagttgagaggtcgaccaacgtttacaaacgaatatgggtaaataatatctgttaccgctacagagtattcgtctttttccaaatgcaaaacttgcggcagacgcgtaacataacgagaagatgtatttt	ttcaaattgagcatttttgacggaagacggtagagttacataaaaatcgttcatgactagagctcacaagttacttgatgtctatttatagctatataaagaactgaaaactgctttcaatcaaaaatgtttttgattttaccacttctaccactactaccactagcatcaagtgtctctgttttcacaaagacggttcc	RevEtaKappa
gtcattgttgcacagtttgtacaaatgactagcctattgactacacaaccattacggagagaataggtgttataaaatgggaagaggccgggtcagggtcactctaatttctaacatatctgatattgtaaatctctaaacattgcttgactcgaattccagattttttttttcgtaaaaactattaagtttaaattaca	cccagagggatcaccaccaggtagtgtacctgaatcccagatccgcagtgcatatcacttgaagaacggatcgtcctttaatcctttaatcctttaaaagaataaaaaatgtgtacataagactttttggtttttttttggtatttgactaaaaatcaggactaaaaaaaccaaaaaatccaaaaaaaaaagtttgccgt	RevEtaKappa
tttaaccgagctgttaaggaaagtggagtgacaagaggcaaaaaagctacatggggtacggtacctaggtacacacatcgatcgattattgaagggatttgggaaggagtatagagaaagaatttgaaaggcagagaggagaagactctaatccgtcgtctagtaatggattagtgataattttttgagtctgtggttag	gaaggagaaaatgaaaaagaagagagcacaaaaacgacgaataaagaaaaaagaagctgtggtcgatattaaataaacactactacaggctggtaagtagggagcaaaaattaatggcaacgaagtgtgtgtgtctgtggagaagaaataaactttccgggattatggggagacggctggaatgcttcgcgggagacagg	RevEtaKappa
cgtgaaagatacaaaaatgtaatcaattacaatattaacaagcacatcaataactacatttgattagttgaccacttttttgtatatgcactggttgctgagctacgatgagttttagtggagctggtccaatttttcaaaactcctttcttttcactatatggcccgtaactccgaaaccagttgaccgatcgaaaaat	ataaaacatttatctgtttattataagcatttaataatttgtaaattttgtatgttactcatgtttgcaaagttaaaagctatcaaaaaaggtaatacacatagttttgaaaaaataggaaaattgttcaataattgagtttttctccccataaaagaagcgttgactaggaaaaatgaatgcaattttttagttagcag	RevEtaKappa
ctatttcataattctaagtcattgatttagcttctctatactttaattggcctttttctaggttttgtaaatttgacaggtttcatgagaatactctagctactattgttagtcagtgcgccaagcgcatttcgacaaaatatcttgacaattagccagtgaattctcttgaattcttttgcccctgctttcgtgtcaaa	acaaaaaaaattgacaaaatttgcctccgaaaatttctcaggcagttgatctgcacaaaaaaacttcaaaatgttctcatttttcttcctttttttgccttcaattgttgtcactatgacacaaatttaacttatcggttcttctttcaaatgctttgttgtttcatttttcttttttctcctatcatttgattgtacca	RevEtaKappa
cgcatacatttttgtatgtaacacaaattcgtgtcgagaccgggaaccgtgttttcacaaaattttgcatagacatgctccaaattaccaagcatgggcctaacaaccaaaatttcaattttttaaaaatttcgatttgctctgtggagcgcgtttgcatccctctggaagctgaaccaccatgtttgatctcccgaatt	aaaaagtgtttgataatcttgtttaattctttcaagctataattatacaagtctctagtttttagattgatctacaatgtgcgctgaaataagtttgacgtcacatttttcagaattttaaattcccgccaattcgggaaatcaaacatggtggttcagcttccaggggatgcaaagacgctccacagaacaaagcgaaa	RevEtaKappa
agtatgttcattcctttctaattcctcccctttctaatatctaaactctacatacaagtatttctttcagtcgagttctgaagaggacggacccgatgatcaaattctccgcaacgtctccccccccccccccccaatgcagcggggaacgatctgcaagaaatgatcactgaggccagaatcaacggaaacgcctacat	aacgacagtgccagaccagcgtttcagcacagagctttcgaaggcctcatccaacacccgcttccattaggacaggacgcattagtatcgagagttcgagcactacaggtcattctatgtggccgcgccgacccaagatacgacgctccattcaatggttcgcccatcttacttcgtcagtacgccgaggacatgattca	RevEtaKappa
acattttattctcattcatacaaaaaaaaagtttactggtgggaatcaagaacttgttgagcagaattcgttggagctgtcatggcagagctcttctcggtactcttcttctcagcagactttttggaatctttcgacttctttccctttttcttcttcttgtccaccggcttctccaaatcctccaacttctcggcagc	gcaactccgatagaaacaaccacgatgattaagatcacgattgtgattatgagaagaaggtacctgaaagaatatataattagtagtttaaaagtctgaaagaataaaacatacttatcccaaaatccactcgccgcttctttctttgcaagattgtagaatcttggcccggcatcctcgatcttcttgttaagactggc	RevEtaKappa
cttctttattttaatgattacgttgagaaataatttaaaaattacaataaaagtggttaagcccattttcatatagatttaacaatgtgagctaaaaaaagtttttcaagttttcaagatttttcacattacaactgtatataaacttctttttttttgagaaacttttccttgttaacttttaatgtaagaaaatttgg	aagtgaacctaattattttcatttgcagaaacttttactacaacatgtcagttaaaaaattcatcagataaaattgttttatacaatattttttgagagtgtaatattctacgcaaacacataaacaaacacgttattgtattttctattttaaatgcacagttgtgaagttggtgtttttttttcattgtagaagaaca	RevEtaKappa
attctgtgcattttttcgttaggcgagcctgtatttgcgtatcttttcagctaccgtaacccagaaaatgctaaaactagtggtggagcaggggtgcgcgacaattgacattcggcaaattcggaaaaccggcaagttgccggtttgccggtttgccgatttgccagaaactccagttatttgccggtttgccggtttgc	cccgattgccagacattccggattttagaaaatccctaaaaccagcaattgccaaacatttcaaaaaccggccactggcgaagttgccgattgccaaaaatttccgaaactggcaattgtcgaaattgtcaattaccgaaaattttcaaaaccggcaattgacgaaattaccgattgccgaaaagctccaaaaccggcaa	RevEtaKappa
gggaaattcaaaaaaaaaaaatttaaaacaatgattttttttaattttaaatatttaaaaaaaaatggaaaaaagtagtaaaaaaaattcaaaaaaaaaacatttttttttaaataaaaaaaggagaacaaaatgagtaaaatggaaaaaaaaaatttaatttaaaagattaatttcgaaaattttgaaaatttccagaa	gtggcttttataggaaatatgtacaattgcttattaaagctcagaagtgatgctctgacactctgcgaagcgattcgccagataaaaaccagccagtgagtggaaaattgcgccgcgccaaaaattcggtagatccacttccttgatattttcgatcttccagcttcttcccactgcacaaatcggccagttttcagcgt	RevEtaKappa
tccacagtcacatcgaaatgtgttcaatctcaaatgatcattgtttttaggatgctcgtagacaaagcgaacgcgctcacttttttgctgtttttctgatacagtgccggttggtcacgataaagtgcaaatcagtagtcaaacatcaaacttatcatagggaaaggaatggagggtgggggtcagatttattaagatat	ttttgcaaaagattttagtaaaatatagaatagaaagtgttgaggtaaatttatcgacaatacatgttttttgtagttttccaatttcggacacttcactataagaacaatgtgatagatattgtttgagtcttctcccacttatgctataaaatttgcgcgcgctctttgttcttgacctgaccgaattcggctctcgc	RevEtaKappa
cagctgatttccttgtttctgctcactcggagcaataaccggaaactggccaaacgcaagttgtctgaactcgagcttgaagagtccaaaatcggtgaatccaagttcaaccaggcttaggagatagtctgaaaaattgttgttcagcctatgttaagccttcctgtctagctgtcttaccattcaaattaaacatgaca	tgaaaatgtccagataggttttattctgtaagtattagttgtaatcgaaaaatattcaatttgaaataaaaacctgtgaaaacttgttacatttcccaaacatcagtctgatagcaggctcgaatttggaagtgatggatgactcgttccttcgcaaaaattctgaatttttccaataatttctaatcaggccgagcacg	RevEtaKappa
atgggcttggtggggaaattgaaagaacacttgaaataacgagaacacgtcaactatgagagcggtgactggacatcaactcttctcaaatagaggtcaggcagtggatgagggtggctagtggctagccaacctcagtcaaccgccgccaggcccaataaaatttattcgctattatattctgttcgcaaaagaatgga	aactggacattccgcttgttgtacttttgatatatttacaggtataaaagtgttaaaatctgctttttgatcataaattaaaataaaatatagaaaaatagtgactccaactgaaaatactatatctaaaatagggtctaaataaagccgtttaattttgaaaatgtggcgaaatctaatttaggcaaacggaaaacttc	RevEtaKappa
cggacctaaaaaagatttcaaagcaactccttctctttttactctttttggcaaaaattctcaatactctatctacattcaatacattagaggtggcccatgatccaagggcacatcggattgtaggtacacttgctcaggaggtacaataatttttaaggtatatctggtttgctcaaatggtacatccatgctatttt	tttaactttaataaattggagtttcaaaaatccgctgcatctattgaataaaactgaatgtaccccttgaatatactatagtatgtagtagtaatagtagtgcgaagcaccacggatgggctcccatggaagtctccggatccacctggatcgaaaacattcgtggtgagaccgagggcttccgccactgatctgggatt	RevEtaKappa
aaacacatacctgaatttcttcaactggttcagctggaacttgaactgaagcttgaactggaacttgaactggagctggtggagatcttgggcgactgcacatcccatcaaattcatcttcttctggcattgggatctgctgaatatcttctggctgcggaggagccattgaattgagaattgttttcggatcatcattt	tcttttttcagcgtgtagttgacggcaccttgactgtgagcttctggcacgatcggcaatatttgtcgccagtcacctcccatgatcatcaaaactcctccaaatggcaaatcactctggtgcattttttgaaagaattggctgcagaattcgtttatcagtcatgcacacctcatcccagatcacacactccacagttg	RevEtaKappa
attcaaagatatttctagattacctgtgacggtacataaactgcttttaacagatcttcaatattaatttataaaaacgaaaaaaaacgtgtcaaagtgactttgcacttttaaagtaatccctctctcaatttcatttttatccaaaataccctctatatttcgaactcatttcgttttcatttgacctcctcttattt	atcgattcgtgaggagcagaaagccattcttaatggtcttttaggtattctttttgcggacggttagtcaaaagtgtactgtagtagaaacgaaaatgtgctttggtgcatgtggattttgtgatgagatactaataatttgtacgcgtgagggtgaattattctttttttgtaaaatttgacgcactaattttttttgg	RevEtaKappa
agtagggaccgtttaattttgaggttttcttgacaaagaacaacaaagttttttagattttggattttgtacattcacgctttatatgcatcgattgacttgccgtctatcagcttgcaaaaatgcagtttttgcttcttcaagtgtatcacggtatgcgtatatttcggcattcctcaaatcatttgactggatattcc	atcgcattgacaaggttcatgacgtcttgttttgcttttatcataacctccactatgcatgttttcgttgggttttcgggagtcagtaaaattttctcaatgttgacggcggtaacaaccaaattttgaaacagcagaatgcttccattcacagatgactgctccagtattgaatttccgtcacaaatcaatattttctg	RevEtaKappa
ttttaaaaaattatcgataatcatgcgaatttgattttttttttctcggtttggacgcagaatcgacgcttctctgtgttctcaatgctttttttctgtaatattgatgctcctgatgaaaaatgaactgaaatttaagattcgccagcctgtgcggcacgctgttcacacaattcgaatcttgaactcttctccgtatt	gtgtcgttacatcctcgtcggtgtatcggaaaggctcgacgacaagcggagtgatcgccggcgcaggtccgaggccaaataaatttagttacactcttggagaggtttgtgctggaaaactattcgaatctataatatatttttaatatgcattttcaggtatgctcaacgaatgtcactctggacgtgaacgtcggcac	RevEtaKappa
aggttttcgaagttcgttttagtcctagaactgataataatcaagatgaataattatagagccatcattctgcagctaatcgttccatcactatatcttgccgcgccttttacatatctctggtattctggtagatttaagtacttcaaccagaaattcacaaatctctcatttatttttatatcaacccatggattatt	aagtaaatttatgtatgtataagcaaaacatcacaaaaatttcgttgtgcttcttccaaaaagagttataattttgacattgacaaaaagcaatcgaaaacattttgttagataaaaatgtttttctaactttcatagtttttgagttatacgtgtttgtaaaattcaaaaaaattatctaaaaaccgaataaaattttg	RevEtaKappa
atcgattttttttttcgaaaatttcgtaaaaaatccattttttcgaaaaaaaccaattcaaaatttcaaaaaaaaagggttttctctccaaattgtaaaaaaatcgatttttctttgaaaattttcttcgaaaaaaaaaagttttattatatttcgtttaaaaaaatcgattttttattgtagaattccgtaaaaaaatg	cactcactacttgaagcccaaaaatcgaaatgtccaatgcaagaactcgcgtcgcaacgggttttgctaatttgtagagaacggttgaaagttcaattggaagaagttcggaggcttcaggcaatgactgttgtcaggcatccaccaccaccgattaatcgacattttaaatcgactatggtcatttcgaatatttcgct	RevEtaKappa
atcacccacacgcgaagtttaccgattttttgcgaaaaacatacggtatcaggtctcgacacgacacccctctttattgtgattacaaaaatttcgttgctgcggaaatttttcaccgattttttaaacaaagatttttcaaactttctcgatgaaaaatatatttacttatgaaaaacaataaaaaaaacaaaaaaatt	ctatttccacgtgatccaagtgaaaatctagctgaaaaaggaaatgaggaagatcgtcgaaaacaaatgataattgattttccggatgacaaagaagtggttatacagagaatgtatcaaattattccacgtgtttttgagcacgatcttgttgttgctggtgagtggttgttatttgaaaaaataaaaatattttacta	RevEtaKappa
ttatttattgcatttaataatttgtgattcatcttgaatcttaatttcatgctcgaataaattagaaattgccgatgtttgggaatctgaacaattgttgaacctcaaacaatttttcacatagtcgctcaaatttttgaaacagacaacttgatatacactcctaacttcaaaaacaattctccaccctagaatttatc	gaagacaggaaaatacaaaattttctggaaactgacgtaaattctttatcgacaaatattcaaaacgtgtcttgccgtttatgttagcaaagattgtcaattaatacaatacacgtaagccttctagatacgcacaaaattaccgcctgcctactttcaagttgtttgattcgtgctgaagtacaaaaaaccgtcctgga	RevEtaKappa
gtttttttccaaattgctttcacattaaaaccccagctccccacacgtcaaaaaatttataatgaatgcgtatcaaggtccacagtagacaacttatcagcgactaaataaacctcgtgcacttctaaaaaattttaaaaaacatgtttacagacaagaggtaaaaattattttagacactccgtttttttttaactata	ggttgccgtacggacttggaggcagtagtttaattctgcctctaaatttcacataaaaattgaatcaattattgacaaactatggcattttttgcagctatctaacggttaaaatattgtaaaatgtggggactatgtcttgctcgctgagagctccttgagcttagcaatagcgtcaagcgctgcattctcatcagctt	RevEtaKappa
ggcagagcatctttcaaattcttattttacgtcagaatttggcattgatgccaacggaagttttgtttgaaatgaagaataaaacattatagaaaatacagtgtgggaaagttctataggaccccccctaatttgaaggtttgaggaacttccgaaaatttttttgaaaaactgctaatgccattcgtttttaaattgaa	caatttaaaaacgaatggcattagcagtttttcaaaaaaattttcggaagttcctcaaaccttcaaattagggggggtcctatagaactttcccacactgtatgttgagttggccgatgttattgcctaggtatacatttgctataaaacggagaggtaagcggtttcagctctagttagggttgtaataaggggagggg	RevEtaKappa
agtccatttgaatgtggtacatggagtatccgggcaatctcgctcacctccgatccaaactcctttttttgtgttttttgcgtaatctaaatatctaaatacagtgtgggaaagttctataggaccccccctaatttgaaggtttgaggaacttccgaaatttttttcgaaaaactgctaatgccgttcgtttttaaatt	caggaagcttgaaacagacttgaacatcaaagatcggaagaatcagaaccagtctggagatcccacgagaacatttcgtattaattttttaaagtcaaaactgcttatctgaactcatttctaactcaaacttgatttgagctttgtcaaaaattccaaaatctgttgattttagtaaaaatcgtgaaaaaaaacggggg	RevEtaKappa
cgcgcgaatacaagctttcgccgttctcacccgttggtctgactccccagcgactgcgggtgtcaacattgatctcaagttcttaaaatctaacagcatacagtgtgggaaagttctataggaccccccctaatttgaaggtttgaggaacttccgaaaatttttttgaaaaactgctaatgccattcgtttttaaattg	ttcaatttaaaaacgaatggcattagcagtttttcaaaaaaattttcggaagttcctcaaaccttcaaattagggggggtcctatagaactttcccacactgtagtttcaataaagaaacatcaccacgttgatcttaagatctcagaatctaacagcatagtttcaaattcaaaaatacgaaatggttgagcaatagag	RevEtaKappa
gtaaagaagaaaaatcaactaattcctacagatgtgtatgaggtttttacagcaagctctgatgcaagttttcaatgtggtgcatttttattcacatacagtgtgggaaagttctataggaccccccctaatttgaaggtttgaggaacttccgaaaatttttttgaaaaactgctaatgccattcgtttttaaattgaa	caatttaaaaacgaatggcattagcagtttttcaaaaaaattttcggaagttcctcaaaccttcaaattagggggggtcctatagaactttcccacactgtatatatatatatttgttgcagattctgattgccgcactttacccaattttcggcttattgttgatgtttgaagtgttgaaagcagccaaagttgcgtca	RevEtaKappa
gtggaccaaaggaaaattttttgcgagttaaaaatcagaaaaaaaaatcaatagtagtactgtaggggtacgctaggagtactgtaggaatacggtaagattactttagttttggaaaaattgtcttttcgtcttttgaagggatattggtttggggttagtggagggatatggtcggggtactgtaggggtacggtagg	aaattgttgcaaaaatcgtttcgagaccttttttcgatgcaccatgaccaaaaatcttgtcctttctttttttggtgttgcggtaaggcgataagtatcgtttcccccaagcatccatcactggatggaaaggaaagatacccgaaaggggggaagatgtcctaaattagtaacacacattgttttatgtaggtctccct	RevEtaKappa
caatttggagactcaatttatttccgaatagttctcgagaagaaataggatatttcgcatttttccgaaatgttacattacctgttgtcggtattacttttaatatttgaaaacgtaagtgcctagacttctaaatttaataaaagataagtatattccagatattagaattatgtatgtgtattacattggtgatactt	ggaacgtggtgtttattcaaacgttggtggccatttggagaagaacttcgcgttttgaatatgaacgaagtacagaatcgtctcgcgtacgtttgctgtgtcaatcagatggaaattgtcaaaaatgctcaatattgttattatgtcaaacttccgattgaaagctttggtatcttcgatttctcaaaattcgaccaggc	RevEtaKappa
ctgcgttgcccactgtcactcagttcatgtcttgcccaagtttaggccaagtttagcccaagttccgctcaagatttgcatgtgtgttgaactccgatcgcatttcccgatgtgctgatctctaacctgttgagccatcgcgcgtgaatgtttgattctatttagtaataatattgcaaattgatgtttcaacttatgcg	ttaaagaattaaaatttcttcaatagaaaaatgagcacaaatggacacatggacttttttagtgaaaaaatagcgctttttgagattttcgataatttctccctcaatcgactcgtctgattttggattttatgctgcgtaactgttttgtcctctctctctctctcgtttattttcaaatcaaatctaaatccaattat	RevEtaKappa
gccgaggcttaggaaatatttatttgaaagccaaacattttaatcatgacctagctatcattttataagttcttaatattactgtcttaaactaactgaacctgtgttcttgggcactatgattttttgagcattttctttgaaaacactgagaaatctaactttcttggacggtcaagtaaattgacttgatcacagaa	gctcataacactcgaaatcagacctcttccccccccgacctgtcaaaaaaatgccccctttctgaattgtcaccttgccaatactcgttcagtcgcttgtgccgaacgcttagtcgcgctgcacgaatatgtacgtgccaataaaatcgatatcctctgcataactgagtccaatctttctacccaaattcctcttgcat	RevEtaKappa
tttcttggcgaaacatttttctgctggagagtgaaatcaaaatgttgaaattttgaaagtttttagtgataaactagtatcaccgttttgctcaacacagcaaactcaagtgttatcagctgtttatgtggggaaaatgaattataatgccgcattccaaaacaaaataaaacaaatacctacttttttgaaaaaaaaaa	gcagtgtaactctgatttttttgaactcgagaataagcgtagcatgagtgttgtagtcaaaaaaaaacaattgtaatatttgtccatgctctctgattccgtgccgagtctgaaatattttaaacagtcgacactcacaaatgatataccgtatttcctctattagtaaagtgcctctattagttttgcacctctattag	RevEtaKappa
aggcgcggtcagcgtctggtaatgcatataatgtatataatgcatataatttatataatgtaaataatgtatataatgtatataatgcatataatttatataatgtatataatgtatgtaatgcatataatgtatataatttatataatgcatataatgtatataatgtatatattgtatataatgtatataatgtatat	tccagaaatcattgcggaagtttcatacacagggaaatataaaagtgagaacagaaaaataaactttatacgaaacacaattagtcagcatcttttgatttcaaactcccaaaggtgaccctcaaagggacaatctccaaaatttatttcaaattcagaattcccgtttgaatactccagggtgaactcatcgccaccag	RevEtaKappa
taaaaaaataactgttaaaaatttgtagaatttttataaattttcataaaatatttgttttccaattttgcaacacaattttttttcgaggtttttggaaacactggttctgacatatttctgaaaaaagttcgtaaaaacgttaaattacattttcataggtcagtattccccggaaattttgaaaaaaaaacctataa	tacattttcataggtcagtattccccggaaattttgaaaaaaaaacctataattaaacaaaacagtttttacatttgtgctatttttcggtaaatttttcacaaaaattttgaggcccgaagagttacttttttactaacttagatattgctgaatacaaaagtttttttgaaaaaattgtgtggtaataacgtagcatt	RevEtaKappa
tgtactttatttttaaaaaaactgtcgcaaacgctatgtaaggaaaaacgttaaaaattcaaaactttcatctgtttcggtaatgtaataaattatcaaaatgtacctacacgatgttattcggtaaacatgctgtagaaacaaaatattttaaaacatctttgaaaaactggaaaagtgtgaaattatgtttcaggttg	tagattttaggtttttaatgataatgaatagttttatatactgtgaatacaacttttactttttgtaattttaattcaagaaaagctaatataacactgtaaaacttggattgtaatgtctgaaatcgacatcataaaactgtaacttttgattttttggttttgaattggttatcactgttgtattgaatattggttct	RevEtaKappa
